---------------------------------------------------------------------------------------------------------------------
---------------------------------------------------------------------------------------------------------------------
---------------------------------------------------------------------------------------------------------------------
---------------------------------------------------------------------------------------------------------------------
---------------------------------------------------------------------------------------------------------------------
---------------------------------------------------------------------------------------------------------------------
---------------------------------------------------------------------------------------------------------------------
--------C-----------------------CC-----------------------------------------------------------------------------------
------BBBB-----------C---C----C---CCCCCC-----------------------------------------------------------------------------
------------------C--------------------------------------------------------------------------------------------------
---------------------------------------------------------------------------------------------------------------------
------E---B------E--------BBB------------------------------EE----EE-----------E-----------E--------------------------
XXXXXXXXXX----XXXX------------------------E-----------E---XXXXXXXXXXXX--------XXXX-EE-----XXXX-E------XXXX-----------
XXXXXXXXXX----XXXXE------------E---------EXXXX--------XXXXXXXXXXXXXXXX-------EXXXXXXXX----XXXXXXXXE---XXXX-----------
XXXXXXXXXX----XXXXXXXX--------XXXX----XXXXXXXX--------XXXXXXXXXXXXXXXX----XXXXXXXXXXXX----XXXXXXXXXXXXXXXX-----------
