---------------------------------------------------------------------------------------------------------------------
---------------------------------------------------------------------------------------------------------------------
---------------------------------------------------------------------------------------------------------------------
---------------------------------------------------------------------------------------------------------------------
---------------------------------------------------------------------------------------------------------------------
---------------------C----C-CC----------------------------C----C-C-CC------------------------------------------------
------------------------------------------C-C----------------------------------------------C-------------------------
--------C-----------C------C----CC---------C-------CC--CC---C---C-C-----CC----C-C--C---C----CC-----C-----------------
----------C-------------C---BBB-BP--CC--CC---C--------C--------B-B-BB--C---CC--C-CC-----C-C----C---------------------
-------BB----C--CC-----C-C---------------------CC---------------------P---C---------CCC---PB----CC-------------------
------------C----------------------C--CC------BBB--B-BB--------------------------------BBB----C----------------------
----------BB------E----------EE---PBB----------------------EE----SS--------------------------------------------------
------S-----------XXXX----XXXXXXXX--------E---------------XXXXXXXXXXXX-ES-----E-----------E--------------------------
XXXXXXXXXX-------SXXXX-EE-XXXXXXXX--------XXXX-SS----EE---XXXXXXXXXXXXXXXX----XXXX-ES----EXXXX----E---XXXX-----------
XXXXXXXXXX----XXXXXXXXXXXXXXXXXXXX--------XXXXXXXXXXXXXXXXXXXXXXXXXXXXXXXX----XXXXXXXXXXXXXXXX----XXXXXXXX-----------
