-----------------------------------------------------------------------------------------------------
-----------------------------------------------------------------------------------------------------
-----------------------------------------------------------------------------------------------------
-----------------------------------------------------------------------------------------------------
-----------------------------------------------------------------------------------------------------
B--------------------BB---E-------XX-----------------B-------------------------------------------B---
-------------------------XX------XXX-----------------------------------------------------------------
-------------------------XX-----XXXX-----------------------------------------------------------------
-----------------CC------XXX----XXXX--E---------------------------------------E--------------E-------
B---------------C---------------XXXX-XX--------------B-----------------------XX-----E-------XX--BB---
------------E-------------------XXXX-XX--XX--------------E-----EX------------XX----XX-------XX-------
----XX-----XX-------------------XXXX-XX--XX-------------XX---X-XX------------XX----XX-------XX-------
----XX--------------------------XXXX-XX--XX---X---------XX--XXXXX------------XX----XX----EE-XX-----EE
XXXXXXXX--XXXXXXXXXXXXXXXXXXXXX-XXXXXXXXXXXXXXXXXXXXXXXXXXXXXXXXXXXXXXXXXXXXXXXX---XX-XXXXXXXX--XXXXX
