---------------------------------------------------------------------------------------------------------------------
---------------------------------------------------------------------------------------------------------------------
---------------------------------------------------------------------------------------------------------------------
---------------------------------------------------------------------------------------------------------------------
---------------------------------------------------------------------------------------------------------------------
-------------------C---------------------------------C---------------------------------------------------------------
--------------------------C----------------C--C--CC-C-----C-C--------------CC----------------------------------------
--------------------CC-------C-----C-C--C------C---------C---C------------C-------C--CC-----------C------------------
------C----CCCC--C-------C-CC--C--B---C---C-CCBBPP-PB--CC-----------C---------------C---C--C-------------------------
--------------------------BBBBC-C------------B------------------------BB-------C---C-----------C---------------------
----------C-----------CC---------------------------------------CCC--------------CC------PBBB-B---C-------------------
--------BBBBB-----E------B----PB-B-EE----------EE----S-------------BBB------------------------B----------------------
XXXXXX------------XXXX-------E----XXXX---ES---XXXXXXXX-----ES---------S-S----E---------------------------------------
XXXXXX------------XXXX----XXXX----XXXXXXXXXXXXXXXXXXXXE---XXXX--------XXXXXXXX-----EE----EE-------E---XXXX-----------
XXXXXX------------XXXX----XXXX----XXXXXXXXXXXXXXXXXXXXXXXXXXXX--------XXXXXXXX----XXXXXXXXXXXX----XXXXXXXX-----------
