-----------------------------------------------------------------------------------------------------
-----------------------------------------------------------------------------------------------------
-----------------------------------------------------------------------------------------------------
-----------------------------------------------------------------------------------------------------
-----------------------------E--E--------------------------------------------------------------------
----------------------------BBBBBBBBBB---------------------------------------------------------------
X--------------------XX------------------------------------------------------------------------------
-----------------X-----------------------------------------------------------------------------------
-----BB---------XX----------------------------------------B------------------------------------------
---------------XXX---------BBBBBBBPBBB-------------------E----------E--------X-----------------------
--------------XXXX---------------------------------------E---------XX--------XX-------------------E-E
XXXX---------XXXXX-------------------------B-----------------X-----XX--------XX----------------------
-----BBBBB--XXXXXX-------------------------b----------------XX-----XX-----E--XX---E------E-----E-----
---------XXXXXXXXX-------XXXXXXXXXXXXXXXXXXXXXXXXXXXXXXXXXXXXXXXXXXXXXXXXXXXXXXXXXXXXXXXXXXXXXXXXXXXX
