-----------------------------------------------------------------------------------------------------
-----------------------------------------------------------------------------------------------------
-----------B-----------------------------------------------------------------------------------------
-----------B-----------------------------------------------------------------------------------------
-----------B-----------------------------------------------------------------------------------------
-----------B--------BBBBBBBB-----------------------------------CC------------------------------------
XXX--------B----------------------X----------------------------X-------------------------------------
-----------B-------E-----------------------------------------------------------------------C---------
-----------B-------------------------------------------------------------------BBP----------E----C---
-----------B-----BPB-E-----B--------------------X----------------XX-----BBBBB-------XX---BBBBB-------
-----------B-----------------------------------XX-----------E-----------------------XX---------------
-----------B----------------------------------XXX----------XX-----------------------XX-------E-------
-----------B----------------EE---------------XXXX----------XX-----------------------XX---------------
--XXXXXXXXXXXXXXXXXXXXXXXXXXXXXXX----------XXXXXX---XXXXXXXXXXX------X-XXXXXXXXXXXXXXXXXXXXXXXXX-----
