---------------------------------------------------------------------------------------------------------------------
---------------------------------------------------------------------------------------------------------------------
---------------------------------------------------------------------------------------------------------------------
---------------------------------------------------------------------------------------------------------------------
---------------------------------------------------------------------------------------------------------------------
---------------------------C---CCC------------------------------C-----------------------C----------------------------
----------CCC---------------CCC----------------C-C------C-----CC----C--C--------------------------C------------------
-------C-C----C--C-C-C-CCCC--------C----------C----------C-------C------CC-------------C-----------C-----------------
-----------PB-------C-C---PPB--B-BC-C------CC---C--C---C---C---BBB----B----CCC-----C-C--BBC----C---------------------
------C--------C------------------B----------CB--B----------CC----BBBB----C---C-CC----------CC--C--------------------
---------B-----B-------------------------C----------------C-----------------------------------C----------------------
-----------EE----------------SS-----------BPBP----BB-------------E-----ES----------------SBBPB-----------------------
----------XXXX----E-------XXXXXXXX-SE---------S-S-----S-------XXXXE---XXXX---------SE-XXXX--------SE-----------------
------S---XXXX---EXXXX-SE-XXXXXXXXXXXX--------XXXX----XXXX----XXXXXXXXXXXX---S----XXXXXXXX--------XXXX---------------
XXXXXXXXXXXXXXXXXXXXXXXXXXXXXXXXXXXXXX--------XXXX----XXXX----XXXXXXXXXXXXXXXX----XXXXXXXX--------XXXXXXXX-----------
