---------------------------------------------------------------------------------------------------------------------
---------------------------------------------------------------------------------------------------------------------
---------------------------------------------------------------------------------------------------------------------
---------------------------------------------------------------------------------------------------------------------
---------------------------------------------------------------------------------------------------------------------
-----------------------C----------------------------------------------C---------------------C----C-------------------
----------------------C---CC----------------------------C--------------CC--------C---------C-------------------------
------C-C-C-------C-C---C----------CC------C--------C--C------------------C-C---C-----CC-CC--CC-C--------------------
-------C-----C-C-C------------C-C-C--C---C---C-----C--BB---CC---CC----BPBB---CC---C-------BB-------------------------
----------BBBB--C-----------------------C---------BPBB---------C-----C-------------C-C-PBB---------------------------
---------B---------------------C-C---------B-B-C------------------CCC---------------C--------------------------------
------------------E----SE------P--------------B--P----S----------B-B-P-SE------------B----S----ESE-------------------
-----------EE-----XXXXXXXX---E-----------------------EXXXX------------XXXX----E----------EXXXXXXXX-------------------
------E---XXXX----XXXXXXXXXXXX-----EE-----E-------XXXXXXXX------------XXXX---SXXXX----XXXXXXXXXXXX-------------------
XXXXXXXXXXXXXX----XXXXXXXXXXXX----XXXX----XXXX----XXXXXXXX------------XXXXXXXXXXXX----XXXXXXXXXXXX----XXXX-----------
