-----------------------------------------------------------------------------------------------------
-----------------------------------------------------------------------------------------------------
-----------------------------------------------------------------------------------------------------
-----------------------------------------------------------------------------------------------------
------E-------------ECCCCC---CC----------------------------------------------------------------------
------E----XX-------XXXXXXX------C------CC--------------------BBBBBBBB-------X--------XX-------------
----------------CC-----------------------------------------------------------------------------------
-----------------------------------------------------------------------------------------------------
C----------------------------------------------E-----------------------------------------------------
---------XX------XXXXXXXXXXXX-XXX-XXXXXX--XXX-XX-------------B--E----B------XXXXXXXXXX-XXX--XXXX-----
----------------------------------------------XX-----------------------------------------------------
----X-----------------------------------------XX-----------------------------------------------------
---XX----------XX-----------------------------XX------------EE--------E--------------------C---------
XXXXX-----------------------------------------XXXX-XXXXXXXXXXXXXXXXXXXXXX------------------X---XXXXXX
