---------------------------------------------------------------------------------------------------------------------
---------------------------------------------------------------------------------------------------------------------
---------------------------------------------------------------------------------------------------------------------
---------------------------------------------------------------------------------------------------------------------
---------------------------------------------------------------------------------------------------------------------
-------------C---------C---C-C---------C--------------C-----------------CC---C-------C-------------------------------
----------C-----C-----C---------------C--C---------------C--------C-C-----CCC-------C----------C---------------------
-------C---------C-------CC-C-CC-C------C-C----C-------CC----C---C------------C-C-----C-C----------------------------
---------CBP-B-C---C------BBBB--C--C-------CC-C--CC-------------C-----BB-B-B---C-C---------CCC-----------------------
--------C-----BP--------------BBB---C--------B--C---C-------C-------BB----------------------BBBBB--------------------
----------------------------------C-----------B----C-C---------------------------------------------------------------
-----------EE----------ES----E----B------E--------PB--E----------------EE----E-----EE--------------------------------
----------XXXX---E----XXXXXXXXE-------XXXXE-----------XXXX--------E---XXXXXXXXE---XXXX----E----EES-------------------
------E---XXXXXXXX----XXXXXXXXXXXX----XXXXXXXX-ES-----XXXX-SE----EXXXXXXXXXXXXXXXXXXXX---EXXXXXXXX-------------------
XXXXXXXXXXXXXXXXXX----XXXXXXXXXXXX----XXXXXXXXXXXX----XXXXXXXXXXXXXXXXXXXXXXXXXXXXXXXXXXXXXXXXXXXX-------------------
