--------------------------------------------------------------------------------------------------------------------
--------------------------------------------------------------------------------------------------------------------
--------------------------------------------------------------------------------------------------------------------
--------------------------------------------------------------------------------X-----------------------------------
---------------------------------------------------------------------------------X----------------------------------
---------------BBBBBBBB---------------------------------------------------BBBBBPBBPX--------------------------------
--------------------------------------------------------------------------------------------------------------------
--------------------------------------------------------------------------------------------------------------------
--------------------------------------------------------------------------------------------------------------------
-----------------------------------XXX--X-X----------------------------------BB--P-------SXX--P---------------------
----------------------------------XXXX--XXX----------------------------------------------EEX------------------------
-------------------------------SXXXXXXXXXXX----------------------------------------------EEX------------------------
-------------------------------XXXXXXXXXXXX-----------------------------------------C----EEX-------C----------------
XXXXXXXXXXXXXXXXXXXXXXXXXXXXXXXXXXXXXXXXXXXXXXXXXXXXXXXXXXXXXXXXXXXXXXXXXXXXXXXXXXXXXXXXXXXXXXXXXXXXXXXXXXXXXXXXXXXX
