---------------------------------------------------------------------------------------------------------------------
---------------------------------------------------------------------------------------------------------------------
---------------------------------------------------------------------------------------------------------------------
---------------------------------------------------------------------------------------------------------------------
---------------------------------------------------------------------------------------------------------------------
-------------------------------------------------C-----------------------------C------C-C----------------------------
-------C------------------C---C-C--CC------C----C-------------CC-C-----------CC--------C----------C------------------
------------CC----C---C----------C------------C----------------------------CC----C-------CC--C---C-------------------
--------C-B------C-------C--CC-------C----C-CCPBBPC--CC-CC----------------C------------B--BBP-C----------------------
-------BBB-----CC---C---C-BBBBP-BB-----------B-----C--------------C--C-C--BBP-------C-----------C--------------------
------------------------BB------------C-CC----------C-------C-----------CC-------------------------------------------
-----------SE----------------------------------EE--B-------------SBPB-PPBP----S----------ES--------------------------
------S---XXXX---------------SS----EE-----E---XXXX----E-------XXXX-----------EXXXX----XXXXXXXX-----E-----------------
XXXXXXXXXXXXXX---ES----ES-XXXXXXXXXXXX----XXXXXXXX----XXXX----XXXX--------XXXXXXXX-S-EXXXXXXXX-SSEXXXX---------------
XXXXXXXXXXXXXXXXXXXXXXXXXXXXXXXXXXXXXX----XXXXXXXX----XXXX----XXXX--------XXXXXXXXXXXXXXXXXXXXXXXXXXXXXXXX-----------
