---------------------------------------------------------------------------------------------------------------------
---------------------------------------------------------------------------------------------------------------------
---------------------------------------------------------------------------------------------------------------------
---------------------------------------------------------------------------------------------------------------------
---------------------------------------------------------------------------------------------------------------------
--------------------------------------------------------------CC-----------------------------------------------------
-------------------CC-C-C-----C-------------------C--CCC---------C----------C----------------------------------------
-------------------------CC--C---C-CCC-------------CC----C---C--------------------CC----C----------------------------
--------C-----CCCC----------C---C-C----CCC----C-------------C--------C---CC--CC-------C--C--C--C---------------------
-------C-----------------B-----BB---------CCCC----BB------C-------C---C----------------C--C--------------------------
------C------C-------------PPP----------------P-PB------------------C--BP---------------BP-C--C--C-C-----------------
------PBBBP-BP------------------------------PP--------E----------E-BBP-------------SE------PBB-B---------------------
------------------E----EE-----E----------------------SXXXX----XXXX-----------E----XXXX----------------XXXX-----------
XXXXXX------------XXXXXXXX---EXXXX-ES----E-----SE-XXXXXXXX-EE-XXXX-----EE-XXXX----XXXX---S------------XXXX-----------
XXXXXX------------XXXXXXXXXXXXXXXXXXXXXXXX----XXXXXXXXXXXXXXXXXXXX----XXXXXXXX----XXXXXXXX------------XXXX-----------
