---------------------------------------------------------------------------------------------------------------------
---------------------------------------------------------------------------------------------------------------------
---------------------------------------------------------------------------------------------------------------------
---------------------------------------------------------------------------------------------------------------------
---------------------------------------------------------------------------------------------------------------------
------------------------------------------C----------------------C------C-----C-CC---------------C-C-----------------
----------------------C----C-----------------------------------CC--------C-----C------------C-C-C--------------------
---------CC--------------CC-C-----CCC----C--C----C-----C-C---------C--CC-----------C---------C-----------------------
------CCC---C---CC-CC---C------C------CC----PB-P-B-CCCC-C-------------BBB---C--------C---B---------------------------
------BPBP--------C--C-------BC-C-B-P------------------B--C----------C-----C-C----C-C-----BBP------------------------
----------B-BB-------------------C----------------C---------------B-BB----C------------------------------------------
------------------------------BBP---------E----EE-B-BB-----------E----S-S-----S----------S-----EE-SE-----------------
------S----------------SE----S-----EE----EXXXXXXXX----E-------XXXX----XXXX----XXXX----XXXXE---XXXXXXXX---------------
XXXXXXXXXX-EE----EE---XXXXXXXX----XXXXXXXXXXXXXXXX----XXXX-ES-XXXXE---XXXX----XXXX-E-EXXXXXXXXXXXXXXXX---------------
XXXXXXXXXXXXXXXXXXXXXXXXXXXXXX----XXXXXXXXXXXXXXXX----XXXXXXXXXXXXXXXXXXXX----XXXXXXXXXXXXXXXXXXXXXXXXXXXX-----------
