---------------------------------------------------------------------------------------------------------------------
---------------------------------------------------------------------------------------------------------------------
---------------------------------------------------------------------------------------------------------------------
---------------------------------------------------------------------------------------------------------------------
---------------------------------------------------------------------------------------------------------------------
---------------------C-C-C----------------C----------------------------------C----CC---------------------------------
----------------C---C---C--------CC-----C----C--C---------------C-------C---C-------------------C--------------------
-------C----------CC--C-----C-C-C-----CC---C--C------------------C----CC-CC----------C--------C----------------------
------C--C-C-----C-------------B----CC------B--C---C-CC--C-----C-----------B-----------C-------C---C-----------------
--------C---C---------------B-----------------BBBB-----CC--------P-C--BBP--------------------CB---C------------------
--------PBC--C------------------------------------C---------------C------------C--------CC--C------------------------
----------BBB-----S----EE-----E----------EE-------B-BBP-B----------BBB------E------SS--PPBBPBB-----------------------
-----------------SXXXXXXXX---EXXXX-ES-XXXXXXXX-SE----------------S-----SS-XXXX----XXXX---------SEE-------------------
------E-------XXXXXXXXXXXXXXXXXXXXXXXXXXXXXXXXXXXX--------E-E-XXXX----XXXXXXXX----XXXX--------XXXX-S-----------------
XXXXXXXXXX----XXXXXXXXXXXXXXXXXXXXXXXXXXXXXXXXXXXX--------XXXXXXXX----XXXXXXXX----XXXX--------XXXXXXXX---------------
