-----------------------------------------------------------------------------------------------------
-----------------------------------------------------------------------------------------------------
BBB---------------------CCC--------------------------------------------------------------------------
------------------------XXXX-------------------------------------------------------------------------
-----------CCCCCCCC----------------------------------------------------------------------------------
-----------XXXXXXXX---------------------------------------------------------BBBBB--------X-X---------
--------------------------------------------------------------------------------------------------C-C
-------------------------------------------------------------------------------------------------XXXX
-----------------------------XXXXX-------------------------------------------------------------------
-XXX--E-E------------XX-------------------------E-------------------------BPBB--B----XXXX------------
EXXX-XXXXXP----------XX-XXXXXX-----------------XX-----------------X----------------------------------
XXXX-----------------XX-----------------X------XX----------------XXX---------------------------------
XXXX-----------------XX----------------XX---E--XX---------------XXXX-------E--E-----------------E----
XXX-------XXXXXXXXX--XX-----------XXXXXXXXXXXXXXXXXXXXXXXXXXXXXXXXXX-X---XXXXXXXXXXXX-------XXXXXXXXX
