---------------------------------------------------------------------------------------------------------------------
---------------------------------------------------------------------------------------------------------------------
---------------------------------------------------------------------------------------------------------------------
---------------------------------------------------------------------------------------------------------------------
---------------------------------------------------------------------------------------------------------------------
---------C---------------C--------------CC--------------------------C-C--C-------------------------------------------
------C-----------C---CC------C--------C--CC------C------------C---C---------------------------CCC-------------------
--------C----------C-------C-----------------C-------------C-CC--------CC--C------------CCC---C----C-----------------
--------B-----C--------BPBC-C--C-C------------C-----CC--CC------CCP-BPBBB---C---------C------------------------------
-------------C-C-------------CBPB-C-CC-----BBP--CCB-PB-----------B--------------C--C-C-C----CC-----------------------
----------PB----CC---------B-B-----------------C------CC----------------------C-----C-BB-----------------------------
------E-----------S----ES----------------S----PBBB----------------S----ES-----------BB---------EEEE------------------
XXXXXXXXXX--------XXXXXXXX----E-------XXXXS----------S-----------EXXXXXXXX--------------------XXXXXXXXXXXX-----------
XXXXXXXXXX-SE-----XXXXXXXX---EXXXX----XXXXXXXX----XXXX-----EE-XXXXXXXXXXXX---E-----------ES---XXXXXXXXXXXX-----------
XXXXXXXXXXXXXX----XXXXXXXXXXXXXXXX----XXXXXXXX----XXXX----XXXXXXXXXXXXXXXXXXXX--------XXXXXXXXXXXXXXXXXXXX-----------
