---------------------------------------------------------------------------------------------------------------------
---------------------------------------------------------------------------------------------------------------------
---------------------------------------------------------------------------------------------------------------------
---------------------------------------------------------------------------------------------------------------------
---------------------------------------------------------------------------------------------------------------------
------CCCC----------------C-C--------------------------C-----C------------------------CC-----------------------------
-----------------------------C---------CC----C--------C--C-CC--------------------------------------------------------
------------C--C-------C---C------CC------C---C---CC----C--------------C----------CC-------------C-C-----------------
--------BB---CC-CC----C---BBBB-------C---C-CC-----------------CC--C---------C-------CC-BBPC-CCC----------------------
------------------C--C--CC----CCC--------------CC---------------CC---------C---C-C-PPP---------C---------------------
----------B-------------BB--------B-------------BB-B-----------------CB-BBC--CC-C---------PB-B-P---------------------
------E----------------------S-PBP--------------------E----EE-------BB----BB-------------S---------------------------
XXXXXXXXXX-------E--------XXXX-----------EE-----------XXXXXXXX---------------------EE-XXXX------------XXXX-----------
XXXXXXXXXX-SE-XXXX-----ES-XXXX-----EE-XXXXXXXX-ES----SXXXXXXXX---------ES---------XXXXXXXX-E---EE-ES--XXXX-----------
XXXXXXXXXXXXXXXXXX----XXXXXXXX----XXXXXXXXXXXXXXXXXXXXXXXXXXXX--------XXXX--------XXXXXXXXXXXXXXXXXXXXXXXX-----------
