--------------------------------------------------------------------------------------------------------------------
--------------------------------------------------------------------------------------------------------------------
--------------------------------------------------------------------------------------------------------------------
--------------------------------------------------------------------------------------------------------------------
--------------------------------------------------------------------------------------------------------------------
----------------B-BBBBB------------------------------------------------------------------------B--------------------
--------------------------------------------------------------------------------------------------------------------
--------------------------------------------------------------------------------------------------------------------
--------------------------------------------------------------------------------------------------------------------
--------------------B------------------XX-----------------------------------------B---------------------------------
----------------------------------XX--XXX---------------------------------------------------------------------------
-------------------------------SX-XX--XXX--------------------------------X------------------------------------------
-------------------------------E--XXXXXXX----------------------------------X------------C---------C-C---------------
XXXXXXXXXXXXXXXXXXXXXXXXXXXXXXXXXXXXXXXXXXXXXXXXXXXXXXXXXXXXXXXXXXXXXXXXXXXXX---XX---XXXX-X--XXXXXXXXXXXXXXXXXXXXXXX
