---------------------------------------------------------------------------------------------------------------------
---------------------------------------------------------------------------------------------------------------------
---------------------------------------------------------------------------------------------------------------------
---------------------------------------------------------------------------------------------------------------------
---------------------------------------------------------------------------------------------------------------------
------------C-------------------------------C------C-C-----------------------------C---------------------------------
-------------C--CC----C--C--CC-C----------CC--C---C-C--C-C-C------------------C---C-C---C------C-C-------------------
---------C----C-----C--C---C-----C-----------C---C----------CC------------C--C--CC-----C-C------C--C-----------------
------C---BPB--C----------C-----C--C-C-CC------BBP-BP-----------C------CCC-----C-------------------------------------
--------BB--------C------PBBBB-BB-C-------------------BP------C-------------------------PP--C------------------------
-----------------------------------------C------------------------C-------BBB----------------------------------------
-----------ES---------------------BPBBB---E----SS----S--------------B-BBBB---------ES-----P--------------------------
------S---XXXX---E-----ES----ES-----------XXXXXXXXXXXXE----E-S----------------E---XXXX---E-----SES-------------------
XXXXXXXXXXXXXXXXXXS---XXXXXXXXXXXX--------XXXXXXXXXXXXXXXXXXXX---------------EXXXXXXXXXXXX----XXXXSE-----------------
XXXXXXXXXXXXXXXXXXXXXXXXXXXXXXXXXX--------XXXXXXXXXXXXXXXXXXXX------------XXXXXXXXXXXXXXXX----XXXXXXXXXXXX-----------
