---------------------------------------------------------------------------------------------------------------------
---------------------------------------------------------------------------------------------------------------------
---------------------------------------------------------------------------------------------------------------------
---------------------------------------------------------------------------------------------------------------------
---------------------------------------------------------------------------------------------------------------------
------------------------C----------------------CC--------C---------------C---------C---------------------------------
-----------------------C--------------------------------C---------------C-------C---C--------------------------------
----------------------C--C-------C----C-C---C-C--C-C---C------C-CC----CC------C------C-------------------------------
---------------------C-----C--C-C-C-------C---BBPB---C-------C----C----BBB-----C-C---PCC----CC-----------------------
-------C----CC--C---------C----------C-C----------BBBB-----C---C-------------------------C------CC-------------------
---------CC----C--C-----------BPBP-C----------------------C-C-------------CC------------C-----CC--C------------------
------BBBPB-BP---------SE---------PB-----------EE-----E-------------P--ES-B--------SS-B-BP---------------------------
XXXXXX----------------XXXX----------------E---XXXX---SXXXX------------XXXX----E---XXXX----S-----------XXXX-----------
XXXXXX----------------XXXX----E---------E-XXXXXXXXXXXXXXXX-------E----XXXX----XXXXXXXX----XXXX--------XXXX-----------
XXXXXX----------------XXXX----XXXX----XXXXXXXXXXXXXXXXXXXX----XXXX----XXXX----XXXXXXXX----XXXX--------XXXX-----------
