-----------------------------------------------------------------------------------------------------
-----------------------------------------------------------------------------------------------------
--------------------------------------------------------------------------------BBBBBBBBBBBBBBBBBBBBB
-------------------------------------------C--------------------------------------------BBB----B-----
--------------------------------------------------------------------------C-------------BBB----B-----
---------------B------------------------BBBB-----B------------------------------------BB-----BB------
--------------------------------------------------------------------------------------BB-----BB------
-C--------------------------------------B---------------------------------------------BB-----BB------
------------------------XXXXXXX--------B-B-------B------------------------------------BB-----BB------
B---------E--BBBBB--------------XX--------B---------E---------------------------------BBBBB--BBB-----
---------XX------------XX-------XX-----------------XX-----------------------------------BBB----B----X
BBB------XX---------------------XXX----------------XX---------------XX------------------BBB----B---XX
---------XX---------E-----------XXX--------E-------XX---------------XX----E-------E----E------E----XX
---XX--XXXXXXXXXXXXXXXX---------XXXXXXXXXXXXX-----XXXXXXXXXXXXX---XXXXXXXXXXXXXXXXXXXXXXXXXXXXXXXXXXX
