--------------------------------------------------------------------------------------------------------------------
--------------------------------------------------------------------------------------------------------------------
-----------------------X--------------------------------------------------------------------------------------------
----------------------XXXX------------------------------------------------------------------------------------------
----------------------XXXX------------------------------------------------------------------------------------------
----------------------XXXXXXXXXBBBB---------------------------------------------------------------------------------
--------------------------------------------------------------------------------------------------------------------
--------------------------------------------------------------------------------------------------------------------
--------------------------------------------------------------------------------------------------------------------
--------------------------------SXX---------------------------------------------------------XX----------------------
--------------------------------EXX---------------------------------------------------------XX---XXX----------------
--------------------------------EEX-----------------------------------------------------SXXXX----XXX----------------
------------------------------C-EEX-------C---------------------------------------------EEXCX----XXX----------------
XXXXXXXXXXXXXXXXX-----XX---SX-X-XEXXX---XXXXXXXXXXXXXXXXXXXXXXXXXXXXXXXXXXXXXXXXXXXXXXXXXXXXXXXXXXXXXXXXXXXXXXXXXXXX
