-----------------------------------------------------------------------------------------------------
-----------------------------------------------------------------------------------------------------
-----------------------------------------------------------------------------------------------------
-----------------------------------------------------------------------------------C-----------------
-----------------------------------------------------------------------------------------------------
-------------------------------C-XXXX-----------------------------------------------X----------------
-----------------CC----------------------------------------------------------------------------------
-----------------------------------------------------------------------------------------------------
X-----------------------P---------------------------------------------------------------------------C
X-----------------------------X-X------------B-------------------------------------------------------
X----------------------------------------------------------------------------------------------------
X----B--------------------------------------------------------------------------------------B---B----
X----b---X------------------E------------------E---E--------EE-------------------------E----b---b-E--
--XXXXXXXXXXXXXX-XXXXXXXXXXXXX-------XX-----XXXXXXXXXXXXXXXXXXXXXXXXXXXXXXXXXXXXX-----XXXXXXXXXXXXXXX
