-----------------------------------------------------------------------------------------------------
-----------------------------------------------------------------------------------------------------
-----------------------------CC----------------------------------------------------------------------
--------------------P-P-----XXXX---------------------------------------------------------------------
-----------------------------------------------------------------------------------------------------
--------------------------------------XXXCCCC----CC--------------------------------------------------
BB---------CCCCCC-------E-------------------------------------------------XXXX---------------XX------
-------------------XXXXXXX------------------------------------------------C--------------------------
--------------------------------------------------XX----------C---------------------------CC---------
------------XXXXXXX------CCC-----XXXXX-------X--------XX---------------------------------------------
-BB------------------------E--------------------------XX---------------------------------------------
------C-C---------XXXXXXXXXXX-------------------------XX---------------------------------------------
----XXXXXXXX------------------------------------------XX----------EEEEE---------------------------E--
XX---------------------------------------------------XX--XXXXXXX-XXXXXXX----XXXXXXXXXXX-------XXXXXXX
