-----------------------------------------------------------------------------------------------------
-----------------------------------------------------------------------------------------------------
BBBBBBBB-------------------------------B-------------------------------------------------------------
---------------------------------------B-------------------------------------------------------------
---------------------------------------B-------------------------------------------------------------
---------------------------------------B---------------E-----------------------PBBBBBBBBBB-----------
---------------------------------------B--------------XX---------------------------------------------
----------------------------E----------B--------------XX---------------------------------------------
-------------P-------------XX----------B--------------XX------CC----------E--------------------------
---------------------------XX----------B--------------XXBBB-------X------XX-------------------E------
-------B---E---------------XX----------B--------------------------X------XX-----B-E----------XX------
-------B-------------------XX----------B--------------------------X----E-XX-----b--------------------
-------B----------------E--XX----------B--------------E-----------X------XX-----B----EEE--------E----
---XXX-XXXXXXXXXXXXXXXXXXXXXXXXXXXXXXXXXXXXXXXXXXXXXXXXXXXXXXXXXXXX-XXXXXXXXXXXXXXXXXXXXXXXXXXXXXXXXX
