-----------------------------------------------------------------------------------------------------
-----------------------------------------------------------------------------------------------------
--------------------------------------------------------------------------------------------BBBBBBBBB
---------------------------------------------------------------------------------------------BBBBBBBB
---XXXX--------------------------------------------------------------------------------------BBBBBBBB
---------------------B----------------------PBBBBBB-------------BBBBBBPB--------XXX-----------B-B----
-------------------------------------------------------------------------------XXXX-----------B-B----
------------------------------------------------------------------------------EXXXX-----------B-B----
XXX----------E---------------------------------------------------------------XXXXXX-----------BCBCCCC
------------XX---BBBPBBBB----------------------------B----------BBBBBBBB----XXXXXXX-----------BBBBBBB
------------XX----------------------E---E----B------------------------------XXXXXXX------------------
------------XX---------------------XX--------b------------------------------XXXXXXX------------------
CC----------XX-EE---E--------------XX--------B----------X-----E-------------XXXXXXX----E-----------E-
XX------XXXXXXXXXXXXXXXXXXXXXXXXXXXXXXXXXXXXXXXXX---XXXXXXXXXXXXXXXXXXXXXXXXXXXXXXXXXXXXXXXXXXXXXXXXX
