-----------------------------------------------------------------------------------------------------
-----------------------------------------------------------------------------------------------------
BBBBBB------------------------------------------BBBBBBBBBBBBBBBBBBBBBBBBBBBBBBBBBBBBBBBBBBB----------
------------------------------------------------BBBBBBBBBBBBBBBBBBBBBBBBBBBBBBBBBBBBBB---------------
------------------------------------------------BBBBBBBBBBBBBBBBBBBBBBBBBBBBBBBBBBBBBB---------------
---------------------------------CC-------------BBBBBBBBBBBBBBBBBBBBBBBBBBBBBBBBBBBBBB---E----E------
--------------XXXXXXXXXXXX----------------------B---------------------------------------XX-----------
------------------------------------------------B---------------------------------------XX-----------
----------------------------------XXXX------CC---PCCCCCCCCC----------P-----E-E-----E----XX-----------
-----XX------------------------------------------PPBBBBBBBB-BBBBBBBBBPPBBBBBBBBBBBBBBB--XXB-----XX---
---XXXX-----------------------------------------------------BBBBBBBB---BBBBBBBBBBBBBBB--XX-----------
-XXXXXX-----------------------------------------------------BBBBBBBB---BBBBBBBBBBBBBBB--XX-----------
XXXXXXX---------------------------------E---------------E-----------CCCBBBBBBBBBBBBBBB--XX---CCC-----
XXXXXX--XXXX----------XXXXXXXXXX------XXXXX-----XXXXXXXXXXXXXXXXXXXXXXXXXXXXXXXXXXXXXXXXXXX--XXX-XXXX
