--------------------------------------------------------------------------------------------------------------------
--------------------------------------------------------------------------------------------------------------------
--------------------------------------------------------------------------------------------------------------------
--------------------------------------------------------------------------------------------------------------------
--------------------------------------------------------------------------------------------------------------------
-----------------------------------------B-----------------------------------------------BB-------------------------
--------------------------------------------------------------------------------------------------------------------
--------------------------------------------------------------------------------------------------------------------
--------------------------------------------------------------------------------------------------------------------
-------------------P--P---P--PB---BBB---------------------------------------------------------XXX--XX---------------
-------------------------------------------------------------------------------------------X--XX---XX---------------
-------------------------------------------------------------------------------------------XXXXXX--XX---------------
------------------------------------------C-----------------------------------------------XXXXXX---XX---------------
XXXXXXXXXXXXXXXXXXXXXXXXXXXXXXXXXXXXXXXXXXXXXXXXXXXXXXXXXXXXXXXXXXXXXXXXXX--XX------------XXXXXXXXXXXXXXXXXXXXXXXXXX
