---------------------------------------------------------------------------------------------------------------------
---------------------------------------------------------------------------------------------------------------------
---------------------------------------------------------------------------------------------------------------------
---------------------------------------------------------------------------------------------------------------------
---------------------------------------------------------------------------------------------------------------------
---------------C---C----------C--------------------------------------------------------------------------------------
--------------C---C-CC----------C----------------------------------------------C------C------------------------------
-------C---------C----C-C-CC---C------CC-------------C--------C--C----CC------C-CC--------------C--------------------
----------PB-----------C------BB----------C-C----------C--C-CC-CC-------CCCC-C---B---C---C--C-CC---------------------
------------------------BP--CC----------C----C-C-C--C-C-C--C--------C-----P---------C--------------------------------
--------------------------BBPB-------C------B-C-C-B-BBP-----------C----BBB--------C--------C-C-----------------------
------E----ES----EE-----------S---------------PBPP-----------------BB---------S----BBB-------------------------------
XXXXXXXXXXXXXXXXXXXXXX-SS-----XXXX-------------------------------E-----------SXXXX-------E-----ESS-------------------
XXXXXXXXXXXXXXXXXXXXXXXXXX---SXXXX-------ES----------EE-------XXXX-----SE-XXXXXXXX----XXXX----XXXX-------------------
XXXXXXXXXXXXXXXXXXXXXXXXXXXXXXXXXX----XXXXXXXX----XXXXXXXX----XXXX----XXXXXXXXXXXX----XXXX----XXXX----XXXX-----------
