--------------------------------------------------------------------------------------------------------------------
--------------------------------------------------------------------------------------------------------------------
--------------------------------------------------------------------------------------------------------------------
-----------------------X--------------------------------------------------------------------------------------------
--------------------------------------------------------------------------------------------------------------------
-----------------------BX-------------PB----------------------------------------------------------------------------
--------------------------------------------------------------------------------------------------------------------
--------------------------------------------------------------------------------------------------------------------
--------------------------------------------------------------------------------------------------------------------
------------------------------------------------------------------------------PB-P------SXX----BB-------------------
----------------------------------------------------------------------------------------EEX-------------------------
---------------------------------X-------------------------------------------------------EX-------------------------
------------------------------------------C------------------------------EX-C-C------C---EX-------------------------
XXXXXXXXXXXXXXXXXXXX-----------X-XXXXXXXXXXXXXXXXXXXXXXXXXXXXXXXXXXXXXXXXXXXXXXXXXXXXXXXXXXXXXXXXXXXXXXXXXXXXXXXXXXX
