-----------------------------------------------------------------------------------------------------
-----------------------------------------------------------------------------------------------------
-----------------------------------------------------------------------------------------------------
-----------------------------------------------------------------------------------------------------
--------------------------------------------------------------------------------------------CC-------
--------------------BB---------------------------BBB----------BB-X-----------------------------C-----
X---------------C------------------------------------------------------------------------------------
---------------XXX---------E-------------------------------------------------------------------------
-----E--------------------XX-----------E-----------------------------------------------BB------XX----
----XX--------------------XX----------XX--------B------------XXXXXXXX--XB----------------------------
----XX---E----------------XX----------XX---------------------X---------X--------E--------------------
----XX--------------------XX----------XX---------------------X---------X-------XX------------XX------
----XX----------------E---XX----X-----XX-------EE------------X---------X-------XX--------------------
XXXXXXXXXXXXXXXXXXXXXXXXXXXXXXXXXXXXXXXXXXXXXXXXXXXXXXXXXXXXXXX-----XXXXXXXXXXXXXXXXXXXXXXX-------XXX
