--------------------------------------------------------------------------------------------------------------------
--------------------------------------------------------------------------------------------------------------------
-----------------------X--------------------------------------------------------------------------------------------
----------------------XX--------------------------------------------------------------------------------------------
----------------------XX--------------------------------------------------------------------------------------------
----------------BBBBBBXBXXX-----------------------------------------------------------------------------------------
--------------------------------------------------------------------------------------------------------------------
--------------------------------------------------------------------------------------------------------------------
--------------------------------------------------------------------------------------------------------------------
----------------P-------B----------------X------------------------------------------P--------------XX---------------
--------------------------------X---X----XX-----------------------------------------------SX-------XX---------------
--------------------------------XX-XX---XXX-----------------------------------------------E--------XX---------------
-------------------------------XXXXXX---XXX--------------------------------------C--C----EE--CX---XXX---------------
XXXXXXXXXXXXXXXXX-----XX----XXXXXXXXXX-XXXXXXXXXXXXXXXXXXXXXXXXXXXXXXXXXXXXXXXXXXXXXXXXXXXXXXXXXXXXXXXXXXXXXXXXXXXXX
