-----------------------------------------------------------------------------------------------------
-----------------------------------------------------------------------------------------------------
-----------------------------------------------------------------------------------------------------
-----------------------------------------------------------------------------------------------------
------------------------------------------------------------------------------------------X----------
--XX----------BBB------------------------------------------------------------------------------------
-----------------------------------------------------------------------------------------------------
----------------------------------------------------------------------------------------------------C
B----------X-----------------------------------------------------------------------------------------
----------EX-BPBB------------------------------------------B----------BB---------------------------BB
---------XXX---------------X------X------------------------------------------------------------------
--------XXXX--------------XX-----XX------------------------------------------------------------------
-------XXXXX-------------XXX---XXXX----------------------------------------------------X-------------
----XXXXXXXXXXXXXXXXXXXXXXXXXXXXXXXXXXXXXXXXXXXXXXXXXXXXXXXXXXXXXXXXXXXXXXXXXXXXXXXXXXXXX---XXX-X--XX
