---------------------------------------------------------------------------------------------------------------------
---------------------------------------------------------------------------------------------------------------------
---------------------------------------------------------------------------------------------------------------------
---------------------------------------------------------------------------------------------------------------------
---------------------------------------------------------------------------------------------------------------------
----------C-C-------------------------------------------CC----------------------C------------------------------------
-----------C-C---CCCC---C---------------------------------C----------------------C-CC----------CC--------------------
---------------------CC---------------------------------------C-C-------------CC------C---CC-C---CCC-----------------
----------PB-B---------C-C---------C-----CCC--CC---C-----------C--C--C-----C-C-------C----B-B-C----------------------
-------C-------P---------PC--C--C-----------CC--C-C-C------------C----CC-------------B-------------------------------
------C--C-----------------C------C----------BBP-BB----------------CC-------C---------BBBB---------------------------
-------B-B-ES-------------PB-BB--B-B------------------E----SE----------BBB----E-----------S--------------------------
XXXXXX----XXXX---EE----ES-----------------------------XXXXXXXX----------------XXXX-EE-----XXXX-EEE-------------------
XXXXXX----XXXXXXXXXXXXXXXX----------------E----EE----EXXXXXXXX---E------------XXXXXXXX---EXXXXXXXXSS-----------------
XXXXXX----XXXXXXXXXXXXXXXX----------------XXXXXXXXXXXXXXXXXXXXXXXX------------XXXXXXXXXXXXXXXXXXXXXXXXXXXX-----------
