-----------------------------------------------------------------------------------------------------
-----------------------------------------------------------------------------------------------------
--CC-------------------------------------------------------------------------------------------------
-XXXX------------------------------------------------------------------------------------------------
---------------------------------------------------------------------------------------CC------------
-----------------------------------E--C---------------BB--------BBBBBB-------------------------------
----------------------------------XX--XX-------------------------------------------------------------
----------------------------------XX-------------------------------------------------X-----XXX-------
----------------------------------XXX----------------------------E-E----------------XX---------------
C------------------------------------------------E---B-----BB---BBBBBB-------------XXX--XX-----------
E--------------E------------------------------E-XX--------------------------------XXXX---------XXXXXX
XX----E--------------------------------------XX-XX-------------------------------XXXXX---------------
----------E----------------------------------XX-XX-EEE-----------------------E--XXXXXX---------------
------XXXXXXXXXXXXXXXXXXXXXXXXX--XXXXX---XXXXXXXXXXXXXXXXXXXXXXXXXXXXXXXXXXXXXXXXXXXXX---------------
