---------------------------------------------------------------------------------------------------------------------
---------------------------------------------------------------------------------------------------------------------
---------------------------------------------------------------------------------------------------------------------
---------------------------------------------------------------------------------------------------------------------
---------------------------------------------------------------------------------------------------------------------
--------CC-C-----------------------------------------------C---------------------------------------------------------
-------C----------CC----------C----------CC-C-C-C----C-C--------------------------C---------C------------------------
----------C-----C---------------CC-----------C---C----C--CC--C----------CC-CCC-----CCC-CC-C--------------------------
---------PP-B----C---------C--B-BP---CC--------C---C--B--------C---C--C----------C---B-----C------C------------------
----------------------------------------------BBBBBPPP------------C-CCBB--C---C-------C---PB--CC-C-------------------
--------------------------C-CC-----C--------------------------C-CCBBPB---------C------BB-B---------------------------
------S----EE------E------BBB-E---BB------------------E----EE----B-----------------EE--------------------------------
XXXXXXXXXXXXXX----XXXX--------XXXX-------SE----SE----EXXXXXXXX---------ES---------XXXX----S--------E-----------------
XXXXXXXXXXXXXX---SXXXX-SE-----XXXX----XXXXXXXXXXXXXXXXXXXXXXXX----E---XXXX---S----XXXX---EXXXX-SEEXXXX---------------
XXXXXXXXXXXXXXXXXXXXXXXXXX----XXXX----XXXXXXXXXXXXXXXXXXXXXXXX----XXXXXXXXXXXX----XXXXXXXXXXXXXXXXXXXX---------------
