---------------------------------------------------------------------------------------------------------------------
---------------------------------------------------------------------------------------------------------------------
---------------------------------------------------------------------------------------------------------------------
---------------------------------------------------------------------------------------------------------------------
---------------------------------------------------------------------------------------------------------------------
-------CC---------------------------C------------------------------------------C-------------------------------------
-------------------------------C-CC--------------------C-C--------------------C-C------------------------------------
------C------C----C-------------C-------CC-C---C----C---C------CCC--------C--------CC--------------------------------
------BBBBC-----C-----------CC--------------C-C-C----C----CC---B-B-C-C---C--------C--------CCCCCC--------------------
-----------C---------CC---C---B-------C----------C-------------------------C---------C-C--C------CC------------------
---------------C-------C-C-C--------------------B-B-BB------C---------------------------BB---------------------------
------S------------------BBBBB-----SS----------------------------SBPBBBBPB----E-------------PBB----------------------
XXXXXXXXXX--------------------E---XXXX-----------------E------XXXX------------XXXX-----------------------------------
XXXXXXXXXX-SE-----S-----------XXXXXXXX---SS---E-E----EXXXX----XXXX-----------SXXXX-EE----S---------------------------
XXXXXXXXXXXXXX----XXXX--------XXXXXXXXXXXXXXXXXXXXXXXXXXXX----XXXX--------XXXXXXXXXXXXXXXX---------------------------
