-----------------------------------------------------------------------------------------------------
-----------------------------------------------------------------------------------------------------
BBBBBBBBBBBBBBBBBBBBBBBBBB---------------------------------------------------------------------------
------------------------------XXXXXX-----------------------------------------------------------------
------------------------------XXXXXX---------------------------------------------------------E-------
------------------------------XXXXXX------BBBB---BBBBBBBB------------------BBBBBBBBBBBBBBBBBBBBBBBB--
------------------------------XXXXXX---------------------------XXXXX---------------------------------
------------------------------XXXXXX-----------------------------------------------------------------
------------------------------XXXXXX---------------------------------------------------------------EE
X---------E------E------------XXXXXX----XX---BBBPBBPBBBBB--------------------------------BB----------
X--------XX-----XX------BB----XXXXXX----XX-----------------E-----------------------E-----------------
X--------XX-----XX------BB----XXXXXX----XX----------------XX-----------------------------------------
X--------XX-----XX------BB----XXXXXX----XX------E----------------------------------------E-----------
XXXX-XXXXXXXXXXXXXX-----XXXXXXXXXXXXXXXXXXXXXXXXXXXX----XXXXXX----XXXXXXXXXXXXXXXXXXXXXXXXXXXXXXXX---
