---------------------------------------------------------------------------------------------------------------------
---------------------------------------------------------------------------------------------------------------------
---------------------------------------------------------------------------------------------------------------------
---------------------------------------------------------------------------------------------------------------------
---------------------------------------------------------------------------------------------------------------------
-----------------------------------C-------------C----------------------------CCC------------------------------------
------C---------------------------C-C-------CCC-C----C---------------------------C--------C---C----------------------
-------C---CC-----CCC---C------------C----C----C-----------------CC----C--C--C----CCCC-------------C-----------------
--------CC----C----------CC----C-C-------------BBBBBP--C--CCC--CC--C-------------------C--BBPP---CC------------------
---------B---C---------------C--------------------------------C-----C-------B---------C-C----------------------------
----------BBP--C-----------CC-C-C------------------------C-------PPPBBPBBB------------BB-P---------------------------
---------------------------P-BBBP--ES----EE----E-E---SB-----------------------E-----------E--------------------------
------E-----------E----EE---------XXXXXXXXXXXXXXXXXXXX-----S-S---------------EXXXX--------XXXXE-E-EE-----------------
XXXXXXXXXX-SS-----XXXXXXXX--------XXXXXXXXXXXXXXXXXXXX----XXXX---EE----EE-XXXXXXXX-SE----EXXXXXXXXXXXX---------------
XXXXXXXXXXXXXX----XXXXXXXX--------XXXXXXXXXXXXXXXXXXXX----XXXXXXXXXXXXXXXXXXXXXXXXXXXXXXXXXXXXXXXXXXXXXXXX-----------
