--------------------------------------------------------------------------------------------------------------------
--------------------------------------------------------------------------------------------------------------------
--------------------------------------------------------------------------------------------------------------------
--------------------------------------------------------------------------------------------------------------------
--------------------------------------------------------------------------------------------------------------------
-------------------------------------BBBB-B---------------------------------BBBP------------------------------------
--------------------------------------------------------------------------------------------------------------------
--------------------------------------------------------------------------------------------------------------------
--------------------------------------------------------------------------------------------------------------------
------------------------------------------------------------------------------P--P------SXX------X------------------
----------------------------------------------------------------------------------------EEX-----XXX-----------------
----------------------------------------------------------------------------------------EEX----XXXX-----------------
------------------------------C-----------C------------------------------EC-C-C------C--EEX----XXXX-----------------
XXXXXXXXXXXXXXX-------------XXXXX-XX---XXXXXXXXXXXXXXXXXXXXXXXXXXXXXXXXXXXXXXXXXXXXXXXXXXXXXXXXXXXXX-XXXXXXXXXXXXXXX
