-----------------------------------------------------------------------------------------------------
-----------------------------------------------------------------------------------------------------
-------------CC------------------------------------BBBBBBBBBBBBBBBBBBBBBBBBBBBBBBBBBBBBBBBBBBBBBBBBBB
-----P------XXXX------------------------------------------------------B-----------BBBBBB--BBBBBBB-BBB
-------------------------------------------------------------------E--B-----------BBBBBB--BBBBBBB-BBB
CC------------------------------XXX--------B-----------------------BBB-------------B-----------BB--BB
X-------E----------------------XXXX----------E---------------------BBB-------------B-----------BB--BB
----XXXXXX--------------------XXXXX--------------------------------BBB-------------B-----------BB--BB
-----------------------------XXXXXX--------------------------------BBB-------------BCCCPP-CCCCCBB--BB
--XX-----CCC-----------------XXXXXX------------B---------E---------BBBB-------E----BBBBB--BBBBBBB--BB
-----------E---------------XXXXXXXX---------------------XX------------B------XX----------------------
---XXXXXXXXXX-------------XXXXXXXXX---------------------XX------------B------XX----------------------
-----------------------------XXXXXX-EE---------------E--XX-E-EE------E-------XX------E-------E--E---E
-------------------XXXXXXXXXXXXXXXXXXXX--XX----XXXXXXXXXXXXXXXXXXXXXXXXXXXXXXXXXXXXXXXXXXXXXXXXXXXXXX
