---------------------------------------------------------------------------------------------------------------------
---------------------------------------------------------------------------------------------------------------------
---------------------------------------------------------------------------------------------------------------------
---------------------------------------------------------------------------------------------------------------------
---------------------------------------------------------------------------------------------------------------------
---------------------------C------C-C---------------CC---------------------------------------------------------------
----------------------C---C---C-------C--C---------------C--C-C------C--------------C-CC-----------------------------
----------C------------C-----C-----C-C-CC--------C-C--CCC----C--C-----C---C--CC--C-C-----------CC--------------------
-----------C------C--C--CCBBPBB-B-------------CC--PB-B---------C-C-CC--CC---------C--------------C-C-----------------
------------C---CC----BPBB--------------------BBBB----------------PBP-----------C----BBPPB---CC---C------------------
----------PB---C--------------------------CCC-------------------------BP-BB---------------C-C------------------------
-----------------------------SE----EE------BBB-------S---------------------------------------------------------------
------E----------------ES-XXXXXXXXXXXX---S-----EE-XXXXE----ES----SS----------------ES----E---------------------------
XXXXXXXXXX-SE-----E---XXXXXXXXXXXXXXXXXXXX----XXXXXXXXXXXXXXXXXXXXXXXX-EE----SS---XXXXXXXX-----ESE----XXXX-----------
XXXXXXXXXXXXXX----XXXXXXXXXXXXXXXXXXXXXXXX----XXXXXXXXXXXXXXXXXXXXXXXXXXXXXXXXXXXXXXXXXXXX----XXXX----XXXX-----------
