---------------------------------------------------------------------------------------------------------------------
---------------------------------------------------------------------------------------------------------------------
---------------------------------------------------------------------------------------------------------------------
---------------------------------------------------------------------------------------------------------------------
---------------------------------------------------------------------------------------------------------------------
--------------------------------------------C----------CC----C--------------C---------CC-----------------------------
---------------C-----------------------CC-C--CC----C-------C-----------------C------------------C--------------------
-------------CC-C-C-CCC----C-C--C--C-------C-----C------------------------CC-----C------C-----CC--C------------------
---------C-C-----C--------C----C-C--C-------------BPBB--------C-C-C-----CCBBP----------BBB--C------------------------
-------C--C-C----------CCC--C-C---C--C---------------------------C-C-C----------C-C--C-------------------------------
-------P-PBB-----------BBBBBPBBBBBPP----------------------------------CC-----------CC------C-C-----------------------
------------------------------------------E----SS----EE----SS-----------BB---E-----------SB----SSE-------------------
-----------------EE----------------------SXXXXXXXXXXXXXXXXXXXX------------XXXX--------XXXX----XXXXE------------------
------S----SS-XXXXXXXX-EE---E-E----EE-XXXXXXXXXXXXXXXXXXXXXXXX------------XXXXS-------XXXX----XXXXXXXXXXXX-----------
XXXXXXXXXXXXXXXXXXXXXXXXXXXXXXXXXXXXXXXXXXXXXXXXXXXXXXXXXXXXXX------------XXXXXXXX----XXXX----XXXXXXXXXXXX-----------
