-----------------------------------------------------------------------------------------------------
-----------------------------------------------------------------------------------------------------
BBBBBBBBBBBBBBBBBBBBBBBBBBBBBBBBBBBBBBBBBBBBBBBBBBBBBBBBBBBPBBBBBBBBBBBBBBBBBBBBBBBBBBBBB------------
-----------------------BB---------------------------------------BBB----------------------------------
-----------------------BB-------------------------E-------------BBB----------------------------------
---------E-----------BB---------E--E--------------BB---CCCCC-----------------------------------------
--------XX-----------BB--------XX-XX--------------BB-------------------------------------------------
--------XX-----------BB-----B--XX-XX--------------BB---BBBBB-----------------------------------------
E----B--XX-----------BB-----B--XX-XX--------------BB---BBBBB----CCPP----E----------------------------
X--E----XX-----E-----BBBB---B--XXBXXBB------XX----BB------------BBB----XX------------------B-------E-
X-XX----XX----XX-------BB------XX-XX-------EXX-------------------------XX--------E------B-------E-XX-
X-XX----XX----XX-------BB------XX-XX-----EXXXX-------------------------XX-------XX------B---------XX-
X-XX----XX----XX------E--------XX-XX-----XXXXX----------------E--------XX-------XX--E---B-----E---XX-
XXXXXXXXXXX--XXXXXXXXXXXXXXXXXXXXXXXXXX-XXXXXXXXXXXXXXXXXXXXXXXXXXXXXXXXXXXXXXXXXXXXXXX-XXXXXXXXXXXXX
