---------------------------------------------------------------------------------------------------------------------
---------------------------------------------------------------------------------------------------------------------
---------------------------------------------------------------------------------------------------------------------
---------------------------------------------------------------------------------------------------------------------
---------------------------------------------------------------------------------------------------------------------
--------------CC-CC--C------------------CCC-----------C--CC-------------------C---CCCC-------------------------------
-------C------------C-------C-CC-----------CCC-----------------C---------------C----------------C--------------------
----------------------C---C-----C--CCCC-----------------C----C--CCC-C-----------C-------------C----------------------
------C-CCC-C-PBB------C-----C----C-------------------B------------C-C-------------BBB-----C-C-----------------------
---------B----------------PBBB-----------------C-----C-----------------CC-CC-C---------C-C--C------------------------
-------------C----------P-------------------------CCC-----------------BPPB--C---------C------------------------------
----------BBBB---SE-----------E----------EE---BBB-BPPPE----SE----E------------E----ES-BPBBBBBB-SES-------------------
------S-------XXXXXXXX-------SXXXX-ES-XXXXXXXX--------XXXXXXXXXXXXE-----------XXXXXXXX--------XXXX-------------------
XXXXXXXXXX----XXXXXXXX-EE-XXXXXXXXXXXXXXXXXXXX--------XXXXXXXXXXXXXXXX-EE-----XXXXXXXX--------XXXXEE--XXXX-----------
XXXXXXXXXX----XXXXXXXXXXXXXXXXXXXXXXXXXXXXXXXX--------XXXXXXXXXXXXXXXXXXXX----XXXXXXXX--------XXXXXXXXXXXX-----------
