-----------------------------------------------------------------------------------------------------
-----------------------------------------------------------------------------------------------------
BBBBBBBBBBBBBBBBBBBBBBBBBBBBBBBBBBBBBBBBBBBBBBBBBBBBBBBBBBBBBBBBBBBBBBBBBBBBB--------BBBBBBB---BBBBBB
-----------------------------------------------------------------------------------------------BBBBBB
-----------------------------------------------------------------------------------------------BBBBBB
CCCCC-------------------------------------------------------E----------------------------------BBBBBB
-----------------------------------------------------------XX----------------------------------B-----
BBBBB-B-B--------------------------------------------------XX----------------------------------B-----
B---BCBCB-------------------B------------B-----------------XX--------------------E--------------PCCCC
B---BBBBB---------------------------BB-------B-------E-----XX------------------EXX--------BB-X--PPBBB
--------------B------------------E------------------XX-----XX--------------XXXXXXX-------------------
--------------B-----------------XX------------------XX-----XX--------------XXXXXXX-------------------
-EEE----------B-----------------XX---EE-----E-------XX-----XX-----E--------XXXXXXX------E------------
XXXXXXXXXXXXX-X---XXXXXXXXXXXXXXXXXXXXXXXXXXXXXXXXXXXXXXXXXXXXXXXXXXXXX----XX-XXXXXXXXXXXXXX---XXXXXX
