---------------------------------------------------------------------------------------------------------------------
---------------------------------------------------------------------------------------------------------------------
---------------------------------------------------------------------------------------------------------------------
---------------------------------------------------------------------------------------------------------------------
---------------------------------------------------------------------------------------------------------------------
-----------CC------------------------------------C-------C----------C----------------------C-------------------------
----------C-------C-C-C-C-----------------------------------------C--------------------------------------------------
-------------C-----C---C-C-CC--------C---------C----CCC------------C----------C-C--C-C------CC-C---------------------
--------C-BPB--------C----C--C-----CC-------CC-BBP-----B------C----------C------------C--CBB--C-C--------------------
---------C----------------------C------C--C--------BPB----C-----------CCC--------------------------------------------
------C-------C-CC-----------B-C-C------------------------------CC--------C-------B-B---C---------C------------------
-------BP--SS----------SE----------------------SE------E-----------E--BBPBBP--E-------BBBBE--------------------------
XXXXXX----XXXX----S---XXXX--------------------XXXX---EXXXX--------XXXX--------XXXX--------XXXX-----------------------
XXXXXX----XXXX----XXXXXXXX---S-----EE----EE---XXXXXXXXXXXX-EE-----XXXX--------XXXX-EE-----XXXX-E---------------------
XXXXXX----XXXX----XXXXXXXXXXXX----XXXXXXXXXXXXXXXXXXXXXXXXXXXX----XXXX--------XXXXXXXX----XXXXXXXX----XXXX-----------
