--------------------------------------------------------------------------------------------------------------------
--------------------------------------------------------------------------------------------------------------------
--------------------------------------------------------------------------------------------------------------------
--------------------------------------------------------------------------------------------------------------------
--------------------------------------------------------------------------------------------------------------------
------------------------------------BBBBBBB---------------------------------BBBP------------------------------------
--------------------------------------------------------------------------------------------------------------------
--------------------------------------------------------------------------------------------------------------------
--------------------------------------------------------------------------------------------------------------------
------------------------B---------------------------------------------------------B--P--------XX-XX-----------------
--------------------------------E------------------------------------------------------------XXX--XX----------------
--------------------------------X--------------------------------------------------------SXXXXX--XXXX---------------
------------------------------C-E-------C-C----------------------------------------C-C---EEXXXXX-XXXX---------------
XXXXXXXXXXXXXXXXXXXXXXXX---XXXXXXXXXXXXXXXXXXXXXXXXXXXXXXXXXXXXXXXXXXXXXXXXXXXXXXXXXXXXXXXXXXXXXXXXXXXXXXXXXXXXXXXXX
