-----------------------------------------------------------------------------------------------------
-----------------------------------------------------------------------------------------------------
-----------------------------------------------------------------------------------------------------
-----------------------------------------------------------------------------------------------------
-----------------------------------------------------------------------------CC----------------------
---BB-----------PBB----------------------------------------------------------------------------------
---------E-------------------------------------------------------------------------------------------
E-------XX---------------------------XX------------------------------------C-------------------------
X-------XX--------------------------XXX-----------------B--BB----------------------------------------
X--BBB--XXX---B--------------------XXXX----------------E----------------B-B------X-----E----------X--
X----------------B-----------------XXXX------E---------E------------------------------XX----------X--
X----------------b-----------------XXXX-----XX------B---------------------------------XX----------X--
X-----------E-E--B-----------E--E-EXXXX-----XX------b------BBBB--------------EE----E--XX-----E---EX--
XXXXXXXXXXXXXXXXXXXXXXXXXXXXXXXXXXXXXXXXXXXXXXXXXXXXXXXXXX----XXXXXXXXXXXXXXXXXXXXXXXXXXXXXXXXXXXXX-X
