-----------------------------------------------------------------------------------------------------
-----------------------------------------------------------------------------------------------------
---------------------------C------------------------------------------------BBBB---------------------
-----------------------------------------------------------------------------------------------------
-----------------------------------------------------------------------------------------------------
---------------P----B------XXXXXXXXXXXXXXX-----------------------------------------------------------
-----------------------------------------------------------------------------------------------------
-----------------------------------------------------------------------------------------------------
------E-------------B-----------------------------------------------------E---------E----------------
----EXX--------B----------------------X----------------------------------XX--BBB---XX---------XXXXXXX
BB-XXXX------E--------------------------------------------X--------------XX--------XX----------------
---XXXX-----XX-------------------------------------------XX--------------XX--------XX----------------
---XXXX----------------------------------------E---------XX--------------XX--------XX----------------
---XXXXXXXXXXXXXX----XXXXXX------------------XXXXXXXXXXXXXXXXXXXXXX----XXXXXXXXX--XXXXXXXXXX---------
