--------------------------------------------------------------------------------------------------------------------
--------------------------------------------------------------------------------------------------------------------
--------------------------------------------------------------------------------------------------------------------
--------------------------------------------------------------------------------------------------------------------
--------------------------------------------------------------------------------------------------------------------
---------------B-----BBB-------------------------------------------------BBB--BBB-----------------------------------
--------------------------------------------------------------------------------------------------------------------
--------------------------------------------------------------------------------------------------------------------
--------------------------------------------------------------------------------------------------------------------
----------------------------------X-XX---XX----------------------------------BB-----P--------XX---------------------
---------------------------------XX-XX---XX-------------------------------------------------XX----XX----------------
--------------------------------XXXXXX---XX---------------------------------------------SXX-XX---XXX----------------
--------------------------------XXXX-X--XXX---------------------------------------------EEXCXX---XXX----------------
XXXXXXXXXXXXXXXXXXXXX---------XXXXXXXXXXXXXXXXXXXXXXXXXXXXXXXXXXXXXXXXXXXXXXXXXXXXXXXXXXXXXXXXXXXXXXXXXXXXXXXXXXXXXX
