-----------------------------------------------------------------------------------------------------
-----------------------------------------------------------------------------------------------------
BBBBBBBBBBBBBBBBBBBBBBBBBBBBBBBBBBBBBBBBBBBBBBBBBBBBBBBBBBBBBBBBBBBBBBBBBBBBBBBBBBBBBBBBBBBBBBBBBPBBB
----------------------------------------------BBB-----------------BBB----------BBB-----B-------------
----------------------------------------------BBB--------------E--BBB----------BBB--E--B-------------
---------------------------------------------------------------BBB------------------BBB--------CCC---
---------------------------------------------------------------BBB------------------BBB--------------
---------------------------------B-----------------------------BBB------------------BBB--------BBB---
-----------------------E---------B-------------E--------E------BBB--------------E---BBB--------BBB---
---E------------------XX---------B------------BBB------XX------BBBBBB----------BBB--BBBB-----X-------
E-XX------------------XX---------------------EE--------XX---B-----BBB--E------EE-------B----EX-------
X-XX------------------XX-------------------------------XX---B-----BBB-XX---------------B--EXXX-------
X-XX------E-----------XX------------------E------------XX---B----E----XX--EE----------E---XXXX-------
XXXXXXXXXXXXXXXXXXXXXXXXXXXXXXXXXXXXXXXXXXXXXXXXX-XXXXXXX---X-XXXXXXXXXXXXXXXXXXXX-XXXXXXXXXXXXXXXXXX
