--------------------------------------------------------------------------------------------------------------------
--------------------------------------------------------------------------------------------------------------------
--------------------------------------------------------------------------------------------------------------------
--------------------------------------------------------------------------------------------------------------------
--------------------------------------------------------------------------------------------------------------------
------------------BB----------------BBB-----------------------------------------------------------------------------
--------------------------------------------------------------------------------------------------------------------
--------------------------------------------------------------------------------------------------------------------
--------------------------------------------------------------------------------------------------------------------
--------------------P----------SXX-----X------------------------------------------B------------X---XX---------------
-------------------------------EEX----XX--------------------------------------------------XX--X----XX---------------
-------------------------------EEX---XXX---------------------------------X----------------XXX------XX---------------
---------------E----C------C---EEX-XXXXXX------------------------------------------------XXXXX----XXX---------------
XXXXXXXXXXXXXXXXXXXXXXXXXXXXXXXXXXXXXXXXXXXXXXXXXXXXXXXXXXXXXXXXXXXXXXXXXXXXX--XXX---------XXXX---XXXXXXXXXXXXXXXXXX
