---------------------------------------------------------------------------------------------------------------------
---------------------------------------------------------------------------------------------------------------------
---------------------------------------------------------------------------------------------------------------------
---------------------------------------------------------------------------------------------------------------------
---------------------------------------------------------------------------------------------------------------------
--------------C----------------------------------------------------CC--------C--------------------CC-----------------
------C---CC----------------------C-----------C-CC-----------C-------C-----C-----------------------------------------
-------------C--CC---------C---CC---CC---------C---CC----------CC-C-----C------------C------C-C----------------------
--------C-B-------CC---------CC----C---C---CCC----C---------------BBP-B-BB--B-----CCC--C-----C--C--------------------
--------BB----------C---C---C----C-------------------CC----------------------------------------C-C-------------------
---------------------C---CBPPBP-PB----C-C----------BBB-C----------------------C---------CCBB-------------------------
-----------EE----E------BB---------------------EE-----B----EE-----E----EE----E----------BB---------E-----------------
------E---XXXXXXXX-----------------ES---------XXXX--------XXXX----XXXXXXXXXXXX-----ES-------------XXXX---------------
XXXXXXXXXXXXXXXXXX-----------EE---XXXX-----E--XXXX---E----XXXX---SXXXXXXXXXXXX----XXXX----S----E--XXXXXXXX-----------
XXXXXXXXXXXXXXXXXX--------XXXXXXXXXXXX----XXXXXXXXXXXX----XXXXXXXXXXXXXXXXXXXX----XXXX----XXXXXXXXXXXXXXXX-----------
