---------------------------------------------------------------------------------------------------------------------
---------------------------------------------------------------------------------------------------------------------
---------------------------------------------------------------------------------------------------------------------
---------------------------------------------------------------------------------------------------------------------
---------------------------------------------------------------------------------------------------------------------
--------------------C--------------------C----C-C------C---------------CC---------CC---------------------------------
----------C-C------C--C--------------------------C--C-C--C--CC-------------------------------------------------------
-------------C----C--C---CC-C-C--CC-C---C------C---C----C--C-------------C--CCC-CC---C----------C--------------------
---------CB-----CC---B-CC---------------------BBBP---C----------C-----B---------------------C--C-C-------------------
------C-C-------------BBB-BPPB-CC---------CC-------BB----------------------------------C-C---------------------------
--------------C----------------BB-----------------------------C-----C-----------------C-C-----B----------------------
--------BB-SE-----E----------------------E---B-ES-----S----------BP-BB-EE----------EE-BP-PB-PP-----------------------
XXXXXX----XXXX----XXXX-ES----E-----EE-XXXX----XXXX---SXXXX-SE---------XXXX---EE---XXXX-------------------------------
XXXXXX----XXXX----XXXXXXXXXXXXE---XXXXXXXX----XXXXXXXXXXXXXXXX--------XXXXXXXXXXXXXXXX---------EESSE-----------------
XXXXXX----XXXX----XXXXXXXXXXXXXXXXXXXXXXXX----XXXXXXXXXXXXXXXX--------XXXXXXXXXXXXXXXX--------XXXXXXXX---------------
