---------------------------------------------------------------------------------------------------------------------
---------------------------------------------------------------------------------------------------------------------
---------------------------------------------------------------------------------------------------------------------
---------------------------------------------------------------------------------------------------------------------
---------------------------------------------------------------------------------------------------------------------
-----------C-C--------------CC---------------------------------------------------------------------------------------
----------C-C-----------C----------C------C------------C-----C------------------------------CC-----------------------
-----------------C-------C----C---C--C-------C-----C--C-CCC----C-------C------C------------C----C--------------------
---------------C----CC-C--BBBP-CC-----CC-C--B-----C--------C--C----CCC--CCCCC--C-----C-C-C-BB----C-C-----------------
------B-BB----C-C--C-----B-------C-------------------C----------CCC---C------------------------C---------------------
------------------------------BPB-------------C--CB-PB----------PBB----PPP---C--------C-C----------------------------
-----------SE----------------E------------E----BBB------------------------P--------------P-E-------------------------
------S---XXXX---------EE-XXXX-----SS-----XXXX--------S----SS-----------------------------XXXX-----------------------
XXXXXXXXXXXXXX---E----XXXXXXXXS---XXXX----XXXX-------EXXXXXXXX---ES----SE-----E----ES-----XXXX-EEE-------------------
XXXXXXXXXXXXXXXXXX----XXXXXXXXXXXXXXXX----XXXX----XXXXXXXXXXXXXXXXXXXXXXXX----XXXXXXXX----XXXXXXXX----XXXX-----------
