--------------------------------------------------------------------------------------------------------------------
-----------------------X--------------------------------------------------------------------------------------------
----------------------XXX-------------------------------------------------------------------------------------------
---------------------XXXX-------------------------------------------------------------------------------------------
---------------------XXXX-------------------------------------------------------------------------------------------
---------------------XXXXXXX---B-B---BBBBBB---------------------------------BBBP------------------------------------
--------------------------------------------------------------------------------------------------------------------
--------------------------------------------------------------------------------------------------------------------
--------------------------------------------------------------------------------------------------------------------
-----------------------------B--------------------------------------------PB-------------------XXX------------------
-----------------------------------------------------------------------------------------------XXX------------------
-----------------------------------------------------------------------------------------SX----XXX------------------
----------------------------C-C----------------------------------------------------------EXXXXXXXX--X---------------
XXXXXXXXXXXXXXXXX----------XXXXXXXXXXXXXXXXXXXXXXXXXXXXXXXXXXXXXXXXXXXXXXXXXXXXXXXXXXXXXXXXXXXXXXXXXXXXXXXXXXXXXXXXX
