--------------------------------------------------------------------------------------------------------------------
--------------------------------------------------------------------------------------------------------------------
--------------------------------------------------------------------------------------------------------------------
--------------------------------------------------------------------------------------------------------------------
--------------------------------------------------------------------------------------------------------------------
------------------BBB---XB------B-----B-------------------------------------------XB------BBP-----------------------
--------------------------------------------------------------------------------------------------------------------
--------------------------------------------------------------------------------------------------------------------
--------------------------------------------------------------------------------------------------------------------
----------------PB------BB------------XX--------------------------------------P--P-------SX-------------------------
--------------------------------------XX-------------------------------------------------EX-------------------------
------------------------------------XXXX---------------------------------SXX-------------E--------X-----------------
-------------------------C-C-EC-----XXXXX-C------------------------------EXXC-C----------E-------XCX----------------
XXXXXXXXXXXXXXXXXXX--XXXXXXXXXXXXXXXXXXXXXXXXXXXXXXXXXXXXXXXXXXXXXXXXXXXXXXXXXXXXXXXXXXXXXXXXXXXXXXXXXXXXXXXXXXXXXXX
