---------------------------------------------------------------------------------------------------------------------
---------------------------------------------------------------------------------------------------------------------
---------------------------------------------------------------------------------------------------------------------
---------------------------------------------------------------------------------------------------------------------
---------------------------------------------------------------------------------------------------------------------
------------------------------------------------------------CC-----C----------------C---------C----------------------
------------C--CC----------------C--------------C--------------------C------------C------------C--CC-----------------
-------------C----C-----C--C----C--C-C---------C----------C-------C-C---------CCC--------C------C--------------------
----------CC-----C----------C-----------C--C--C--CC-C------------C-BP---C-CC-----------------------------------------
-------C--B-B-P--------C-CC---B-P--------------BPB-------------C------C--C--C---------CCC---C------------------------
---------------------------B-----------C-C--CC-------C-CC--------------------C-----------B-C-------------------------
------B--P-------------------------ES--------B----PB--B----EE-----E---BBPBB--------EE-----BPBP-S---------------------
-----------EE----E------------S---XXXX---------ES---------XXXX----XXXX------------XXXX--------XXXXE---XXXX-----------
XXXXXX----XXXXXXXXE----SE----EXXXXXXXX--------XXXX--------XXXX----XXXX--------E---XXXX---S----XXXXXXXXXXXX-----------
XXXXXX----XXXXXXXXXXXXXXXXXXXXXXXXXXXX--------XXXX--------XXXX----XXXX--------XXXXXXXXXXXX----XXXXXXXXXXXX-----------
