---------------------------------------------------------------------------------------------------------------------
---------------------------------------------------------------------------------------------------------------------
---------------------------------------------------------------------------------------------------------------------
---------------------------------------------------------------------------------------------------------------------
---------------------------------------------------------------------------------------------------------------------
-------------------C-----------------------C-C---------C-C----C------------------------------C-----------------------
----------C---------------C----C--------------------C-C---C-CC-------------C--C--------------------------------------
-------C-C----------C-------C---CCC------C--C-----C-----C--C-----C-------C--C---C------C-C-----C-C-------------------
------C----CCCC---------C--C--B-BB--CC--C----BC--C----PB---------------C--C--C-C--CCCC----PB--C----C-----------------
--------C--------------C-CB--P-----C----------BBBBP-PB------------C-CCBBB---------------C----------------------------
---------B------------------------BB--------------------------------PB---------------B--BB----BB---------------------
------------------S-----------E-----------S-----------E----SS----E------------------------S--------------------------
-----------EE-----XXXX-------EXXXX--------XXXX-EE----EXXXXXXXXXXXX-----EE----ES-----------XXXX-----------------------
------E---XXXX---EXXXX-SE-XXXXXXXX-SS----EXXXXXXXXXXXXXXXXXXXXXXXXE---XXXXXXXXXXXX-ES----EXXXX-SE-----XXXX-----------
XXXXXXXXXXXXXXXXXXXXXXXXXXXXXXXXXXXXXXXXXXXXXXXXXXXXXXXXXXXXXXXXXXXXXXXXXXXXXXXXXXXXXXXXXXXXXXXXXXXXXXXXXX-----------
