--------------------------------------------------------------------------------------------------------------------
-----------------------X--------------------------------------------------------------------------------------------
----------------------XX--------------------------------------------------------------------------------------------
---------------------XXXX-------------------------------------------------------------------------------------------
---------------------XXXX-------------------------------------------------------------------------------------------
---------------------XXXXXXX---BBB-------------------------------------------------------BBB--BBBB------------------
--------------------------------------------------------------------------------------------------------------------
--------------------------------------------------------------------------------------------------------------------
--------------------------------------------------------------------------------------------------------------------
--------------------------------------------------------------------------------P------P----------------------------
-----------------------------------------------------------------------------------------------XX-------------------
--------------------------------SX--X----XX---------------------------------------------------XXX--X----------------
--------------------------------E--CX---XXX-------------------------------------------------X-XXXXX-X---------------
XXXXXXXXXXXXXXXX------X----XXXXXXXXXXXXXXXXXXXXXXXXXXXXXXXXXXXXXXXXXXXXXXXXXXXXXXXXXXXXXXXXXXXXXXXXXXXXXXXXXXXXXXXXX
