-----------------------------------------------------------------------------------------------------
-----------------------------------------------------------------------------------------------------
-----------------------------------------------------------------------------------------------------
-----------------------------------------------------------------------------------------------------
---------------------------------------------------------------------------------------C-------------
BBBB----------CCC------------------------------------------------------------------B-----------------
--------------X-----CCCCCCCCC----------------------E-E--C--------------------------------------------
------------------------------------X------XXXXXXXXXXXX----------------------------------------------
----------------XX-----------------XX----------------------------------------------------------------
E-BBB-XXXX------------------------XXX---E-------------------------E-B-----CC-------P-----------B-----
---------------------------------XXXX-XXXXXX---------------------XX-------------------------------E--
---------------------------------XXXX----------------------------XX------------------------------XX--
--E------------------------------XXXX----------------------------XX-----E--------------E---------XX--
XXXXXX---X--XX-----XXXXXXXXXXXXXXXXXX-------------------XXXXXXXXXXXXXXXXXXXXXXXXXXXXXXXXXXXXXXXXXXXXX
