---------------------------------------------------------------------------------------------------------------------
---------------------------------------------------------------------------------------------------------------------
---------------------------------------------------------------------------------------------------------------------
---------------------------------------------------------------------------------------------------------------------
---------------------------------------------------------------------------------------------------------------------
-----------------------------------------------C----------------------------------------------C----------------------
-----------C------------------------CC-C--------CC----------------C-C-----CC----------------C--C--C------------------
-------C--C---C-----C--------C----CC--C-------C---------C------------CC------C------------------C--C-----------------
------C----------C---CC--C--------------------PBB----CCC---C----C--C---C-C----C-CC--C-C--CCC-C-----------------------
---------CBBB-----CC-------C--C----B---------C----C-C-------------PBBB--C----------C--BP-BP--------------------------
------BBBP-----------------PBB---C--------C-C-------------------------P-B---------C--C-------------------------------
---------------------------------P-------------ES-B-BB-----------------------E-----BBB---------EEESS-----------------
-----------EE----S----------------E-S----E----XXXX---------------E-S------XXXX-----------SS---XXXXXXXX---------------
------E---XXXXXXXXE----EE----S----XXXXXXXX----XXXX----E-------XXXXXXXX-ES-XXXXS-------XXXXXXXXXXXXXXXX---------------
XXXXXXXXXXXXXXXXXXXXXXXXXXXXXX----XXXXXXXX----XXXX----XXXX----XXXXXXXXXXXXXXXXXXXX----XXXXXXXXXXXXXXXX---------------
