-----------------------------------------------------------------------------------------------------
-----------------------------------------------------------------------------------------------------
-----------------------------------------------------------------------------------------------------
-----------------------------------------------------------------------------------------------------
-----------------------------------------------------------------------------E-----------------------
----------------------X-----------BB-BB----------E-E------BBBBBBBBBBBB----BBBBB---B--------BBBBBB----
---------------------XX-------------------XXXXXXXXXXXXX----------------------------------------------
--------------------XXX------------------------------------------------------------------------------
--------------------XXX-------------E--------------------------------------E-------------------------
XXX-------XX-------XXXX---------------------------------------------------BBBBBBBBB-----BBBPBBBBB-BB-
------------------XXXXX------------------XX----------------------------------------------------------
----X------------XXXXXX------------------------X--------------------------------------------------E--
-----------------XXXXXX------------------------------------------------------------------------------
------X-------XXXXXXXXXXXXXXXXXXXXX----XX----------------XXXXXXXXXXXXXXXXXXXXXXXXXXXXXXXXXXXXXXXXXXXX
