--------------------------------------------------------------------------------------------------------------------
--------------------------------------------------------------------------------------------------------------------
-----------------------X--------------------------------------------------------------------------------------------
----------------------XX--------------------------------------------------------------------------------------------
----------------------XX--------------------------------------------------------------------------------------------
------------------BB-P-XXXX-----------B-----------------------------------------------------------------------------
--------------------------------------------------------------------------------------------------------------------
-----------------C--------------------------------------------------------------------------------------------------
--------------------------------------------------------------------------------------------------------------------
----------------PB-----P-----------------------------------------------------------------------XX-------------------
-----------------------------------------------------------------------------------------------XX---X---------------
--------------------------------SXX----------------------------------------------------SXX-X--XXX--XX---------------
---------------------C----------EEX----------------------------------------------------EXX-XX-XXX---X---------------
XXXXXXXXXXXXXXXXXXXXXXXXXXXXXXXXXXXXXXXXXXXXXXXXXXXXXXXXXXXXXXXXXXXXXXXXXXXXXXX----XXXXXXXXXXXXXXXXXXXXXXXXXXXXXXXXX
