-----------------------------------------------------------------------------------------------------
-----------------------------------------------------------------------------------------------------
-----------------------------------------------------------------------------------------------------
-----------------------------------------------------------------------------------------------------
-----------------------------------------------------------------------------------------------------
----------------------------------------------B-------------------------P------------------BBB-------
-------------------C-C-C-C-C-C-----------------------------------------------------------------------
------------------XXXXXXXXXXXXX----------------------------------------------------------------------
-------------E--------------------E-----------B----------------------------------------------------E-
------------XX-------------------XX------------------------BPB-----------------------------BBB----XX-
------------XX-------------------XX---E----XX-----------------------------------------------------XX-
E-----------XX-------------------XX--XX---XXX------------B----------------------------------------XX-
---------EE-XX-------------------XX--XX-XXXXX----X-------b--------E---------E---------------------XX-
XXXXXXXXXXXXXXXXX-XXXXXXXXXXXXXXXXXXXXXXXXXX---XXXXXXXXXXXXXXXXXXXXXXXXXXXXXXXXXXXXXX---XXXXXXXXXXXXX
