---------------------------------------------------------------------------------------------------------------------
---------------------------------------------------------------------------------------------------------------------
---------------------------------------------------------------------------------------------------------------------
---------------------------------------------------------------------------------------------------------------------
---------------------------------------------------------------------------------------------------------------------
---------C----------------CCC--------C--------------C-----CCC-C---------------------C--------------------------------
------C-----------C---CCC---------CC------C---CC------C-C-------C------------C-------------C-------------------------
-------C-----CCCC--------C---C--------------C----CCC-C-------C-----------C-CC------------C--------C------------------
---------P-C-----------B-BBBBPC-C-----C--C-C-CBPB---B------------------CC---------BP-PCCC---C-C----------------------
----------PP---------------------C-----CC---B-----------------------C-BP--------------PBBBB-P---C--------------------
-------------------------------C-----------------------------------C-C---------------------------C-------------------
------E----------E-----SE----EPBP--S-E---------EE----EE----EE----S--P--------E-----EE--------------------------------
XXXXXXXXXX-EE-XXXXS---XXXXXXXX----XXXX----S---XXXXXXXXXXXXXXXXXXXX-----EE-XXXXS---XXXX---EE-------XXXX---------------
XXXXXXXXXXXXXXXXXXXXXXXXXXXXXX----XXXX---EXXXXXXXXXXXXXXXXXXXXXXXX----XXXXXXXXXXXXXXXXXXXXXXXX----XXXX---------------
XXXXXXXXXXXXXXXXXXXXXXXXXXXXXX----XXXXXXXXXXXXXXXXXXXXXXXXXXXXXXXX----XXXXXXXXXXXXXXXXXXXXXXXX----XXXXXXXX-----------
