-----------------------------------------------------------------------------------------------------
-----------------------------------------------------------------------------------------------------
BBBBBBBBBBBBBBBBBBBBBBBBBBBBBBBBBBBBBB---------------------------------------------------------------
BBBBBBBBBBBBBBBBBBBBBB-------------------------------------------------------------------------------
BBBBBBBBBBBBBBBBBBBBBB-------------------------------------------------------------------------------
BBBBBBBBBBBBBBBBBBBBBB---------------------XXXXXX---------------CCC----------------------------------
------------------------------------C-----XXXXXXX--------------XX-------------------E---E------------
-----------------------------------------EXXXXXXX---------------------------------XXXXXXXXX----------
CCCCCCCC---P-----E-----------------B----XXXXXXXXX-----------------------------------------------E---X
PBBBBBBB-BBPPBBBBBBBBB--E----XXXXX-----EXXXXXXXXX-----------XX-----XX---------EE---------------XX--XX
---------B---BBBBBBBBB-XX---XXXXXXX--XXXXXXXXXXXX----------XXX---------XXXXXXXXXXXX------------XX--XX
---------B---BBBBBBBBB-XX-EXXXXXXXX--XXXXXXXXXXXX--XX-----XXXX---------------------------------XX--XX
--EE------CCCBBBBBBBBB-XX-XXXXXXXXXE-XXXXXXXXXXXX--XX---XXXXX----------------------------------XX--XX
XXXXXXXXXXXXXXXXXXXXXXXXXXXXXXXXXXXXXXXXXXXXXXXXXXXXXXXXXXXXX-------------------------------XXXXXXXXX
