-----------------------------------------------------------------------------------------------------
-----------------------------------------------------------------------------------------------------
-----------------------------------------------------------------------------------------C-----------
X---------------------------------------------------------------------------------------XXX----------
--------------------------------------------------------------------------CC---C---------------------
-------------E------------------X--------------XX----------------BBBB---------XXX--------------------
-------XXXXXXXXXXX---CCCCC--------------------XXX---------------------------------C-E----------------
-------------------------------------------XXXXXX--------------------------------XXXXX---------------
------------------------------------------XXXXXXX-CCCC--------------------------------------C----XXXX
----------------------------B------------XXXXXXXX---------------XXXXXXXXX------------CCC-------------
XXXXXXXX--------------------------------XXXXXXXXX------------E--X----------------C-----E-------------
-----------X---------------------------XXXXXXXXXX-----------XX--X----------XXX--XXXXXXXXX------------
-------------------E-------EE---------XXXXXXXXXXX-----------XX--X--------------------------------CCC-
----------------XXXXXXXXXXXXXXX-XXXXXXXXXXXXXXXXXXXXXXXXXXXXXXXXXXXX--------------------------XXXXXX-
