-----------------------------------------------------------------------------------------------------
-----------------------------------------------------------------------------------------------------
-----------------------------------------------------------------------------------------------------
-----------------------------------------------------------------------------------------------------
-------------------------------------------------------------------------------------------------EC--
-------------------------------BBBBBBB-----------------------------------------------------------XXX-
-----------------------------------------------------------------------------------------------------
B----------------------------------------------------------------------------------------------------
b--------------P---------------------------------------------------------XBB-------------------------
XBBB-------------------B----------BBBB----E----------------BB-----X----XXXX---------E------XX---XXXXX
--------------------------------E--------XX-----------------------X---XXXXX--------XX----------------
-------------------------------XX--------XX-XX---X----------------X---XXXXX--------XX----------------
-------------------------------XX--------XX-XX--XXX------E--------X---XXXXX--------XX----------C-----
XXXXXXXXX--XXXXXXXXXXXXXXXXXXXXXXXXXXXXXXXXXXXXXXXXXXXXXXXXXXXXXX-XXXXXXXX-----XXXXXXXXXX------X-----
