---------------------------------------------------------------------------------------------------------------------
---------------------------------------------------------------------------------------------------------------------
---------------------------------------------------------------------------------------------------------------------
---------------------------------------------------------------------------------------------------------------------
---------------------------------------------------------------------------------------------------------------------
-------------C--------C------------C--------------------------------------------CC-----------------------------------
-------C----------------CC-----CC---C----------------C-----CC---------CC-CC-C--------------C-C-----------------------
--------C---C-C-C------C---------C---C------C---C---C----C---C-------------C--C---CC-C---C----CC---------------------
------C--CB-BB---CC---------C---------C---CC--C---C---C---C---CC---C---------C---------CC-------C-C------------------
---------P-----C-----C----C--C--PB----------BP-C-CBBBB----------C-C---PBBBP-P---------C------------------------------
---------------B------------BB----------------BPBB------------------BP-----------------PBB---------------------------
-----------EE----------ES----------ES-----------------------------------------E-----------E--------------------------
------E---XXXX--------XXXX----S---XXXX----E----------S-----ES----------SE----SXXXX--------XXXX-ES--------------------
XXXXXXXXXXXXXX---ES---XXXX---EXXXXXXXX---EXXXX-ES-XXXXS---XXXX----E---XXXXXXXXXXXX-ES----SXXXXXXXX-------------------
XXXXXXXXXXXXXXXXXXXXXXXXXXXXXXXXXXXXXXXXXXXXXXXXXXXXXXXXXXXXXX----XXXXXXXXXXXXXXXXXXXXXXXXXXXXXXXX----XXXX-----------
