---------------------------------------------------------------------------------------------------------------------
---------------------------------------------------------------------------------------------------------------------
---------------------------------------------------------------------------------------------------------------------
---------------------------------------------------------------------------------------------------------------------
---------------------------------------------------------------------------------------------------------------------
----------CC-C------CCC-C---C--------------C------------------C-------------C---------C-C----------------------------
-------C-------C---C---------------------------C-----C-----C-----C---C----C------------C------C-C--------------------
--------C---C---C------C---C-------C--C---C--C---C--C---CC--------CC-------C-------CC-----CCC--C-C-------------------
------C----P--------B-BBP-BBPB------C-------B---C-----C-----CC------C-C-C-BP------------BB---C-----------------------
--------BB----------------------C----C-CC------P-BBB-B-C-----------B-B-C-------------C-------------------------------
-------------------------------------------------------------------------------C-------------------------------------
-----------EE----S-E---SE----EP-----------E----------------------S----BB-P---E-----------E-----SSE-------------------
------E---XXXXXXXXXXXXXXXXXXXX------------XXXX-EE----E-----SS-XXXXE-------XXXX--------XXXX----XXXX-------------------
XXXXXXXXXXXXXXXXXXXXXXXXXXXXXX-----EE----EXXXXXXXXXXXXE---XXXXXXXXXXXX----XXXX-----ES-XXXXE---XXXX----XXXX-----------
XXXXXXXXXXXXXXXXXXXXXXXXXXXXXX----XXXXXXXXXXXXXXXXXXXXXXXXXXXXXXXXXXXX----XXXX----XXXXXXXXXXXXXXXX----XXXX-----------
