---------------------------------------------------------------------------------------------------------------------
---------------------------------------------------------------------------------------------------------------------
---------------------------------------------------------------------------------------------------------------------
---------------------------------------------------------------------------------------------------------------------
---------------------------------------------------------------------------------------------------------------------
-------------------------------------------CC--CC----------------------C-C---------------------C--C------------------
------------C---------------C---------------------C-C--CCC--------C---C---------------C--C-C-CC-CC-C-----------------
------------------C---C---CC-C-C-------C-----CC----C-------C-------C------C-------------C----------------------------
-------CCCCC-C-CC--------C----C--------------BBPBB----C---C---C--C--BBB-----C-----CCCCPBBB---------------------------
----------B---C--C-CC---C--BBB---CC-CC------------B------------------------C-----C--------P--------------------------
------C-------B---------------BBBB-----------------------------C----------------C------------------------------------
-------B-P------------------------P-B-----E----ES-----------------S----SS---------B--B---E-----EE-SE-----------------
-----------ES----------------E------------XXXXXXXX---EE----SE-----XXXXXXXX------------XXXXS---XXXXXXXX---------------
XXXXXX----XXXX---EE----ES-XXXXE----------EXXXXXXXXXXXXXXXXXXXX----XXXXXXXX---E--------XXXXXXXXXXXXXXXX---------------
XXXXXX----XXXXXXXXXXXXXXXXXXXXXXXX----XXXXXXXXXXXXXXXXXXXXXXXX----XXXXXXXXXXXX--------XXXXXXXXXXXXXXXXXXXX-----------
