-----------------------------------------------------------------------------------------------------
-----------------------------------------------------------------------------------------------------
-----------------------------------------------------------------------------------------------------
-----------------------------------------------------------------------------------------------------
EC---------------------------------------------------------------------------------------------------
XXXXXXXXXX------------BBB----------------------------------------BBBBBBBB----------------------------
-----------------------------------------------------------------------------------------------------
-------------------------------------------------E---------------------------------------------------
------------------------------------------------XX---------------------------------------------------
XXX--X------B--------XXXXX-------------B--------XX------------BBBB------EB--------------------------B
-------------------XXXX-------------------------XX---E-----------------XX----------------------------
-----------------XXXX---------------------------XX--XX-----------------XX----------------------------
-----------EE-E--XXX--------E---------E---------XX----------------E----XX----------------------------
----------XXXXXXXX-----XXXXXXXXX--XXXXXXXXX---XXXXXXXXXXXXXXXXXXXXXXXXXXXXXXXXXXXXXXXXXXXXXXXXXXXXXXX
