--------------------------------------------------------------------------------------------------------------------
--------------------------------------------------------------------------------------------------------------------
----------------------XX--------------------------------------------------------------------------------------------
---------------------XXXX-------------------------------------------------------------------------------------------
---------------------XXXX-------------------------------------------------------------------------------------------
---------------------XXXXXXX--------------------------------------------------BBB-----------------------------------
--------------------------------------------------------------------------------------------------------------------
--------------------------------------------------------------------------------------------------------------------
--------------------------------------------------------------------------------------------------------------------
-------------------------------------B-----------------------------------------------P--------XX-XX-----------------
--------------------------------X-----------------------------------------------------------XXX--XXX----------------
--------------------------------X-------------------------------------------------------SXX-XXX--XXX----------------
------------------------------C-E-------------------------------------------------CC----EEXCXXXX-XXXX---------------
XXXXXXXXXXXXXXX---------------XXXXXXXXXXXXXXXXXXXXXXXXXXXXXXXXXXXXXXXXXXXXXXXXXXXXXXXXXXXXXXXXXXXXXXXXXXXXXXXXXXXXXX
