---------------------------------------------------------------------------------------------------------------------
---------------------------------------------------------------------------------------------------------------------
---------------------------------------------------------------------------------------------------------------------
---------------------------------------------------------------------------------------------------------------------
---------------------------------------------------------------------------------------------------------------------
-------C--------------------C----------------------------C-------C---------------------------------------------------
------C----C-C-------C----CC------C-CC---------------CC-------CC------------C-C--------CC-C--------C-----------------
---------CC------------------C--C--C------------CCCCC--C--------C--C-C-------C----C---C----C------C------------------
--------BB--C----C----C----PBB----BBP-CC---C-CC-------PB----CC----C-------CC---C---------C--C------------------------
----------BBB---C-------C-----CC---------CC----C--BBPB--------------------PB-------CCCBBBPB---CCCC-------------------
-----------------------C-C----BBBB----------C--BPB--------CC-------B-P--C------------P-------------------------------
------S-----------E----------E-----EE-----------------E----------E----BB---------------------------------------------
XXXXXXXXXX-SE-----XXXX----XXXX----XXXX---------------EXXXX----XXXX-----------SE----------ES-------XXXX---------------
XXXXXXXXXXXXXX----XXXX----XXXXE---XXXX---E-----EE-XXXXXXXX----XXXXE-------XXXXXXXX-ES-XXXXXXXX-EESXXXXXXXX-----------
XXXXXXXXXXXXXX----XXXX----XXXXXXXXXXXXXXXX----XXXXXXXXXXXX----XXXXXXXX----XXXXXXXXXXXXXXXXXXXXXXXXXXXXXXXX-----------
