-----------------------------------------------------------------------------------------------------
-----------------------------------------------------------------------------------------------------
-----------------------------------------------------------------------------------------------------
-----------------------------------------------------------------------------------------------------
--------------------------------------------------------------------------------X--------------------
------------BB---------P----------------------------------------------------XXX-------------------BB-
----------------------------------------------------------------------------XXX----------------------
------------------------------------------------------------X--------------XXXX----------------------
BB-------------PP---------------------------------------------------------XXXXX---------E------------
------------BB----------------------------EB--E--------------------------XXXXXX--------XX----------EB
---------------------------------------------XX-------------------------XXXXXXX--------XX---------XX-
-------------------XX------------------------XX------------------------XXXXXXXX--------XX---------XX-
BBBBB---EE---------XXX-----------------------XX------------E-E--------XXXXXXXXX--------XX---------XX-
----XXXXXXXXXXXXXXXXXXXXXXXXXXXXX---XXXXXXXXXXXXXXXXXXXXXXXXXXXXXXXXXXXXXXXXXXXXXXXXXXXXXXXXXXXXXXXXX
