-----------------------------------------------------------------------------------------------------
-----------------------------------------------------------------------------------------------------
BBBBBBBBBBBBBBBBBBBBBBBBBBBBBBBBBBBBBBBBBBBBBBBBBBBBBBBBBBBBBBBBBBBBBBBBBBBBB------------------------
BBBBB----------------------------------BBBBB---------------------------------------------------------
BBBBB----------------------------------BBBBB---------------------------------------------------------
---------------------------------------BBBBB-----------------------E--------------BBB----------------
------------------------------------------------C-----------------XX--------------------------------E
------------------------------------------------------------------XX-------------------------------XX
-E---------------------------B-----------------B------------------XX----E--------------------------XX
BBBBB-------------------------------E-------XX----X-------------E-XXB--XX---------BB---X-----------XX
E----------------------------------XX------XXXX--XX------E-----XX-XX---XX---B------------------------
-----------------------------------XX-----XXXXX--XX-----XX-----XX-XX---XX---B------------------------
---------E---------------EE--------XX----XXXXXXE-XX-----XX-E---XX-XX---XX---B-E----------------------
XXXXX-XXXXXXXXXXXXXX-XXXXXXXXXXXXXXXXX--XXXXXXXXXXXXXXXXXXXXXXXXXXXXXX-XX---XXXXXXXXXXXXXXXXXXXXXXXXX
