-----------------------------------------------------------------------------------------------------
-----------------------------------------------------------------------------------------------------
BBBBBBBBBBBBBBBBBBBBBBBBBBBBBBBBBBBBBBBBBB-----------------------------------------------------------
BBBB-----------------------------------------------------------------------E-------------------------
BBBB-----E----------------------------------------------------ECCCC-------XXX------------------------
---------BB---------------------------------------------------XXXXXX-----------------------BBB-------
---------BB---------C--------------------------------------------------------------CC----------------
---------BB------------------------------------------------------------------------------------------
---------BB--------B------------------------------------------------------------------------E--------
BBBB-----BB------------XXXX-------------------XXXXXXX------XXXXXXXXXXXXX-------------------BBB------B
BBBB-------------XX--XXXXXX---X-XX--X--X-XXX-------------------------------------------E-------------
BBBB------------XXX--XXXXXX--XXXXX--XXXXXXXX---------------------------------------------------------
---------------XXXXE-XXXXXX--XXXXX--XXXXXXX--C-----------------------------------------------------EE
XXXXXXXXXXXX-XXXXXXXXXXXXXXXXXXXX---XXXXXX---X--------XXXXX------------------------XXXXXXXXXXXXXXXXXX
