-----------------------------------------------------------------------------------------------------
-----------------------------------------------------------------------------------------------------
-----------------------------------------------------------------------------------------------------
-----------------------------------------------------------------------------------------------------
----------CCCCC--------------------------------------------------------------------------------------
----------------------------------------XXXXXX---------------------BB----------BBBBBBBB--------------
--------------------XXXXXXX-------X-----XXXXXX-------------------------------------------------------
--------X--XX-----------------X---------XXXXXX-------------------------------------------------------
B------XX-------------------------------XXXXXX------CCC----------------------------------------------
------XXX-------------------XX----------XXXXXX-----------------XXXXXXX--------BB---BB-BBB-----------E
-----XXXX-------------------------------XXXXXX----------------XXXXX--------------------------------XX
----XXXXX-----XXXXXXX--------XXXXXXXXX--XXXXXX----------------XXXXX--------------------------------XX
---XXXXXX-------------------------------XXXXXX------------E---XXXXX-------------EE-E--EE-----------XX
XXXXXXXXX-XX----------------------------XXXXXXXXXXXXXXXXXXXXXXXXXXXXXX-XXXXXXXXXXXXXXXXXXXXXXXXXXXXXX
