---------------------------------------------------------------------------------------------------------------------
---------------------------------------------------------------------------------------------------------------------
---------------------------------------------------------------------------------------------------------------------
---------------------------------------------------------------------------------------------------------------------
---------------------------------------------------------------------------------------------------------------------
--------------CCC---------C---------------------------------------------------C--------------------------------------
-----------------C------------------C-----C-C--C-C----CCC------------------------------------------------------------
---------------------------C-C----C-----C--C-CC-C--------C-------------------------CCCC-C------C---------------------
------CC--C-C-BB---C------------C--------C---B------CC---------C------C---C-------C------C-C-C--CC-------------------
--------C--C-C------CC--C------C-C----CC------BP-B-----------C--C---C---C-BP---------B-C------C----------------------
-------PBP-P-B----------------B-BB------------------------CC-----CCC---BPB------------PBPP----B----------------------
-----------------E-----------E-----EE-----S-------BBB-E-----------------------E-----------BBBB-----------------------
--------------XXXX--------XXXX----XXXX----XXXX-SE-----XXXX-------------------EXXXX-EE--------------------------------
------E----SE-XXXX--------XXXXE---XXXX---EXXXXXXXX----XXXX-------------SS-XXXXXXXXXXXX--E------ESESE--XXXX-----------
XXXXXXXXXXXXXXXXXX--------XXXXXXXXXXXXXXXXXXXXXXXX----XXXX------------XXXXXXXXXXXXXXXXXXXX----XXXXXXXXXXXX-----------
