--------------------------------------------------------------------------------------------------------------------
--------------------------------------------------------------------------------------------------------------------
--------------------------------------------------------------------------------------------------------------------
--------------------------------------------------------------------------------------------------------------------
--------------------------------------------------------------------------------------------------------------------
--------------------------------------------------------------------------BBBBBBBBP---------------------------------
--------------------------------------------------------------------------------------------------------------------
--------------------------------------------------------------------------------------------------------------------
--------------------------------------------------------------------------------------------------------------------
-----------------------------B-------XX------------------------------------B------BB-P------X-----------------------
-------------------------------------XX-----------------------------------------------------XX---XX-----------------
--------------------------------SXX--XX---X--------------------------------------------SXX-XXX--XXX-----------------
----------------------------C-C-EEX-XXX---C----------------------------------------C---EEXXXXX-XXXX-----------------
XXXXXXXXXXXXXXXXXXX-XXXX--XXXXXXXXX--XXXXXXXXXXXXXXXXXXXXXXXXXXXXXXXXXXXXXXXXXXXXXXXXXXXXXXXXXXXXXXXXXXXXXXXXXXXXXXX
