-----------------------------------------------------------------------------------------------------
-----------------------------------------------------------------------------------------------------
BBBBBBBBBBBBBBBBBBBBBBBBBBBBBBBBBBBBBBBBBBBBBBB-----C------------------------------------------------
B----------------------------------------------------------------------------------------------------
B----------------------------------------------------------------------------------------------------
------------------------------------------------CCC--------------------------------------------------
----------C--C---------------------------------------------------------------------------------------
-----------------------------------------------------------------------------------------------------
---------B--B-------------------------------------XXXX------X-------XBB------------------------------
B---------------------------------------BBBBB-B---------X--XX------XXX--------BBB-------E------------
B------XX--X--XX--XX------------------------------------X-XXX-----XXXX--------E--------XX------------
B----EXXX--X--XXXXXX------------------------------------XXXXX-----XXXX-----------------XX------------
-----XXXXE-XE-XXXXXX----------------EE------EE----------XXXXX-----XXXX----E------------XX------------
XXXXXXXXXXXXXXXXXXX---------------XXXXXXXXXXXXX--------XXXXXXXXXXXXXX----XXX-XXXXXXXXXXXXXXXXXX--XXXX
