-----------------------------------------------------------------------------------------------------
-----------------------------------------------------------------------------------------------------
CC---------------------------------------------------------------------------------------------------
XXX--------------------------------------------------------------------------------------------------
------------CCCCC----------------------------CCCCCC---------------C----------------------------------
------------XXXXX----------------------------XXXXXX--------------------------------------------------
----------------------------------------------------------------------CCCCCC-------------------------
-----------------------------------------------------------------------------------------------------
---------------------------------------------------------------------------------------B-------------
------------------X---------------BB-----------------------------------------------B--E-------------X
-----------P------------------------------XXP-----------------------------------------E-------------X
----------------------------------------------------------------------------------------------------X
-------------------------------EE----EEE------------------E-EE-E--E---------------------------------X
-------X-X-XXXXXX---XXXXXXXXXXXXXXXXXXXXX---XXXXXXX-XXXXXXXXXXXXXXXX-XXXXXXXXXXXXXXXXXXXXXXXXXXXXXXXX
