--------------------------------------------------------------------------------------------------------------------
--------------------------------------------------------------------------------------------------------------------
--------------------------------------------------------------------------------------------------------------------
-----------------------XX-------------------------------------------------------------------------------------------
------------------------X-------------------------------------------------------------------------------------------
------------------------XX-----BBB--BBBX----------------------------------B--BBBBB----------------------------------
--------------------------------------------------------------------------------------------------------------------
--------------------------------------------------------------------------------------------------------------------
--------------------------------------------------------------------------------------------------------------------
----------------P--------------------XXX-------------------------------------------------------B--------------------
-------------------------------------XXX----------------------------------------------------------------------------
---------------------------------X-X-XXX-----------------------------------------------SXX--------------------------
------------------------------C--XXXXXXX-------------------------------------------C---EEX--------------------------
XXXXXXXXXXXXXXXXXX--XXX----XXXXXXXXXXXXXXXXXXXXXXXXXXXXXXXXXXXXXXXXXXXXXXXXXXXXX-XXXXXXXXXXXXXXXXXXXXXXXXXXXXXXXXXXX
