--------------------------------------------------------------------------------------------------------------------
--------------------------------------------------------------------------------------------------------------------
--------------------------------------------------------------------------------------------------------------------
--------------------------------------------------------------------------------------------------------------------
--------------------------------------------------------------------------------------------------------------------
--------------------BP----------------------------------------------------B-BBBBB-----------------------------------
--------------------------------------------------------------------------------------------------------------------
--------------------------------------------------------------------------------------------------------------------
--------------------------------------------------------------------------------------------------------------------
-------------------BBB------------B----------------------------------------B------------SXX-----XX------------------
------------------------------SX--------------------------------------------------------EEX-----XXX-----------------
-----------------------------SEX--------XSX----------------------------------------------EX--XXXXXXX----------------
-----------------------------EEX-C------EEX---------------------------------------C-C----EX--XXXXXXXX---------------
XXXXXXXXXXXXXXXXXXXXXXXXXXXXXXXXXXXXXXXXXXXXXXXXXXXXXXXXXXXXXXXXXXXXXXXXXXXXXXXXXXXXXXXXXXXXXXXXXXXXXXXXXXXXXXXXXXXX
