--------------------------------------------------------------------------------------------------------------------
--------------------------------------------------------------------------------------------------------------------
--------------------------------------------------------------------------------------------------------------------
-----------------------X--------------------------------------------------------------------------------------------
--------------------------------------------------------------------------------------------------------------------
---------------B---------------------------------------------------------BBB----B---------------B-------------------
--------------------------------------------------------------------------------------------------------------------
--------------------------------------------------------------------------------------------------------------------
--------------------------------------------------------------------------------------------------------------------
--------------------------------------------------------------------------------------------X---XX------------------
-------------------------------------------------------------------------------------------X---XXX------------------
-----------------------------SXX-----------------------------------------------------------XXXXXXX------------------
-----------------------------EEX-----------------------------------------------------------XXXXXXXX-----------------
XXXXXXXXXXXXXXX---XX---------XXXXXXXXXXXXXXXXXXXXXXXXXXXXXXXXXXXXXXXXXXXXXXXXXXXX-XXXXXXXXXXXXXXXXXXXXXXXXXXXXXXXXXX
