---------------------------------------------------------------------------------------------------------------------
---------------------------------------------------------------------------------------------------------------------
---------------------------------------------------------------------------------------------------------------------
---------------------------------------------------------------------------------------------------------------------
---------------------------------------------------------------------------------------------------------------------
-------------C----CC-C--C------------------------------------------C----------------------C-CC-C---------------------
---------C---------------C------C---------CC------------------------------CC---------------C-------------------------
------------C-------C-C------------------------------CC-----C-C-----C-------CC----------------C--C-------------------
------CC---PBBC-----------C-C-CC---CCC---C--CC---------C-------C-C-BBBC--CBBB-------------BPB-----C------------------
---------------C-C----------BB-BB------C----PB-C--CC--BBB-------C------C------C---CC---C-----------C-----------------
----------------------------------BP----C-----C---BBBP-------------------------C------C-C----------------------------
-----------ES-B---E----EE---------------------BBB-----------------E---BBBP---S----------BBE----EE--------------------
-------E--XXXX----XXXXXXXX---ES-----------E-----------S-----------XXXX----XXXX------------XXXXXXXX-------------------
XXXXXXXXXXXXXX----XXXXXXXXXXXXXXXX-EE-----XXXX-------EXXXX-EE----EXXXX----XXXX------------XXXXXXXXEE--XXXX-----------
XXXXXXXXXXXXXX----XXXXXXXXXXXXXXXXXXXX----XXXX----XXXXXXXXXXXXXXXXXXXX----XXXX------------XXXXXXXXXXXXXXXX-----------
