---------------------------------------------------------------------------------------------------------------------
---------------------------------------------------------------------------------------------------------------------
---------------------------------------------------------------------------------------------------------------------
---------------------------------------------------------------------------------------------------------------------
---------------------------------------------------------------------------------------------------------------------
---------------CC-----------------------------------------------------------------------------C--C-------------------
-----------------C----------------------C---CC-----C------------CCC--C-C---C-------C------C--C-C---------------------
----------C-C-C---------------C-C-----C----C------C--C-------------CC--------C------C-C-C---C---C--------------------
------C----C-CP---C----C-C-C---C-C------------C----------CC--CCC---BBB----B-------C--C--BB---------------------------
--------C---------------C----------C--------PP-----B--C-C--------------BBB------CC--------BBBB----C------------------
-------C-CPB-P-----C--C---C-C--BBBC-CC--------BBBB---------CC--------------------------------------------------------
------B-B--------E-----------P----BB------------------------------E----------S-----------E-----ES--------------------
--------------XXXX-----------------------SE----------E-----------SXXXX-EE-XXXX-----ES-XXXXS---XXXX-------------------
-----------EE-XXXX------------E-------XXXXXXXX-EE-XXXX--------XXXXXXXXXXXXXXXXE---XXXXXXXXXXXXXXXXES-----------------
XXXXXX----XXXXXXXX------------XXXX----XXXXXXXXXXXXXXXX--------XXXXXXXXXXXXXXXXXXXXXXXXXXXXXXXXXXXXXXXXXXXX-----------
