-----------------------------------------------------------------------------------------------------
-----------------------------------------------------------------------------------------------------
-----------------------------------------------------------------------------------------------------
-----------------------------------------------------------------------------------------------------
-----------------------------------------------------------------------------------------------------
---------------------B----------CC-------------BBBB-----------------BBBB-------E---E--E--------------
------------------------------------------------------------------------------XXXXXXXXXXX------------
-----------------------------------------------------------------------------------------------------
CCCCCCCC-------------------------XXXXXX--------------------------------------------------------------
--------C-------------------------------------X---------------------BBBB-----------------------------
----------------------E-E---------------XX---XX------------------------------------------------------
---------------------XXXX---------------XX---XXX-----------------------------------------------------
---------------------XXXX---------------XX---XXX-------------------E------------------------EE-------
-X-XXXXXXXXXXXXXXXXXXXXXXXXXX-----------X---XXXXX--------------XXXXXXXXXXXXXX--------------XXXXXXXXXX
