---------------------------------------------------------------------------------------------------------------------
---------------------------------------------------------------------------------------------------------------------
---------------------------------------------------------------------------------------------------------------------
---------------------------------------------------------------------------------------------------------------------
---------------------------------------------------------------------------------------------------------------------
-------------------------------------------------------------------------------------------CC------------------------
------------------------C----------C-------C---------C----------------C-C--C------------C---------C------------------
-----------C-C-----------C--C-CC--C--C------C---CC--C--------C---------C-CC-C----------------------------------------
-------CC-C-C-C--CC---C----C-----------------CC-------C-----C--C--C--CBBB-----C-C--C--C--C----CC---------------------
------C--CBBBP-C--------BP---------------C--BBBBPBBPB--CC-------C---C-------------C-----PP---------------------------
----------------C--C------PP-----------------------------C-------C--PB---------C-C---C-------------------------------
------BBBB----B---------------------------------------BP---------------SS-----------BB----E--------S-----------------
-----------EE----------SS-----E----ES-----S----ES----E-----ES---------XXXX---E-----------EXXXX----XXXX---------------
XXXXXX----XXXX--------XXXX---SXXXXXXXX---EXXXXXXXXXXXX----XXXX----S---XXXXXXXX--------XXXXXXXX----XXXX---------------
XXXXXX----XXXX--------XXXXXXXXXXXXXXXXXXXXXXXXXXXXXXXX----XXXX----XXXXXXXXXXXX--------XXXXXXXX----XXXXXXXX-----------
