--------------------------------------------------------------------------------------------------------------------
--------------------------------------------------------------------------------------------------------------------
--------------------------------------------------------------------------------------------------------------------
----------------------------------------------------------------------------------X---------------------------------
----------------------------------------------------------------------------------X---------------------------------
---------------BB-----B---------------BB-------------------------------------------------------BBBBBB---------------
--------------------------------------------------------------------------------------------------------------------
----------------------------------------------------------------------------------------------C---------------------
--------------------------------------------------------------------------------------------------------------------
----------------------------------X----------------------------------------------------B----BBB-----B---------------
---------------------------------X----------------------------------------------------------------------------------
--------------------------------XX----------------------------------------------------------------------------------
--------------------------------X-X----------------------------------------------------EC----------C----------------
XXXXXXXXXXXXXXXX-XXXX------------X-X-XXXXXXXXXXXXXXXXXXXXXXXXXXXXXXXXXXXXXXX----XXXXXXXXXXXXXXXXXXXXXXXXXXXXXXXXXXXX
