--------------------------------------------------------------------------------------------------------------------
--------------------------------------------------------------------------------------------------------------------
--------------------------------------------------------------------------------------------------------------------
--------------------------------------------------------------------------------------------------------------------
--------------------------------------------------------------------------------------------------------------------
----------------B--BBBB-----------------------------------------------------BBBP------------------------------------
--------------------------------------------------------------------------------------------------------------------
--------------------------------------------------------------------------------------------------------------------
--------------------------------------------------------------------------------------------------------------------
--------------------B---------SXX------X-----------------------------------B--P--P------SXX------X------------------
------------------------------EEX------XX-----------------------------------------------EEX--X---XX-----------------
------------------------------EEX------XXX-----------------------------------------------EX--XX-XXXX----------------
------------------------------EEX------XXXX-------------------------------C-C-C----------EX--XXXXXXX----------------
XXXXXXXXXXXXXXXXXXXXXXXXXXXXXXXXXXXXXXXXXXXXXXXXXXXXXXXXXXXXXXXXXXXXXXXXXXXXXXXXXXXXXXXXXXXXXXXXXXXXXXXXXXXXXXXXXXXX
