---------------------------------------------------------------------------------------------------------------------
---------------------------------------------------------------------------------------------------------------------
---------------------------------------------------------------------------------------------------------------------
---------------------------------------------------------------------------------------------------------------------
---------------------------------------------------------------------------------------------------------------------
------C-------------C---------------------------------------C----C---------------------------------------------------
-------CCC-C---------C----------C---------CCC-------------------C--C------CC---C-C-----------------------------------
-------------C----CC--C--C-------CC--C-C-C----CC-C--------CC--CC--C----------CC------C-----------C-------------------
--------BBP---CCCC--------CC---C---CC---C------BB--CCC---C--------BBB-------------C-C-C------C-C---------------------
-----------------------C----CC-B------------------C---C------------------CBPB------C---CC--CC-C----------------------
-------------------------B--------BB-B------------PPBB-CC-------------CC------------------C--------------------------
------E----EE-----S--------BBB------------E----ES-----P----EE----EE---BBBB-------------PBBBP-------------------------
XXXXXXXXXXXXXX----XXXX--------E----------EXXXXXXXX--------XXXXXXXXXXXX-------EE--------------------------------------
XXXXXXXXXXXXXX----XXXX-SE-----XXXX-ES-XXXXXXXXXXXX---S----XXXXXXXXXXXX----XXXXXXXX-SS----------SSS-------------------
XXXXXXXXXXXXXX----XXXXXXXX----XXXXXXXXXXXXXXXXXXXXXXXX----XXXXXXXXXXXX----XXXXXXXXXXXX--------XXXX-------------------
