-----------------------------------------------------------------------------------------------------
-----------------------------------------------------------------------------------------------------
BBBBBBBBBBBBBBBBBBBBBBBBBBBBBB-----------------------------------------------------------------------
BBBBBBBBBBBBBBBBBBBBBBBBBBBBB------------------------------------------------------------------------
BBBBBBBBBBBBBBBBBBBBBBBBBBBBB-------------------------CCCCCCCCCCC------------------------------------
BBBBBBBBBBBBBBBBBBBBBBBBBBBBB---------------------------------------------------------------------P--
------------------------------------C----------------------------------------------------------------
-------------------------------------------------------------XX-----------------E--------------------
PCCCCCCCCCCCCCCCCCCCCCCCC------------------------------------------------------XX---C-CCCC-----------
PPBBBBBBBBBBBBBBBBBBBBBBB----XX------------------------------------------------XX-----------------B--
----------------------------XXX------------------------------------------------XX--------------------
---------------------------XXXX---------------------------------XXXXXXX--------XX--------------------
---------------EEEE--E----XXXXX------------E--EEEE-----------------------------XX--------------E-----
XXXXXXXXXXXXXXXXXXXXXXXXXXXXXX--XXXXXXXXXXXXXXXXXXX-X-XXXXXXXX----------XXXXXXXXXXXXXXXXXXX-XXXXXXXXX
