-----------------------------------------------------------------------------------------------------
-----------------------------------------------------------------------------------------------------
----------BBBBBBBBBBB--------------------------------------------------------------------------------
-----------------------------------------------------------------------------------------------------
-----------------------------------------------------------------ECCC--C-----------------------------
BBB----------------------XXX---C----------------------------X----XXXXXXXX----------------------------
--------------------------------------------------------------------------C-----XXX------------------
-------------------------------------------------------------------------XXXXX-----------------------
-----------------------------------------------------------------------------------------------------
BBB---------E--BBBBBB------XXXX-XX-------B----X---------XXXXXXXXXXXXXX------------------B------------
-----------XX--------------------------------XX--------------------------C-----------------E-E-------
-----------XX----------XX-------------------XXX-------------------------XXXXXXXXX---------XX---------
-------EE--XX-E----------------------------XXXX------E------------------------------------XX---------
--XXXXXXXXXXXXXXXXXXX------------XXXXXXXXXXXXXXXXXXXXXX---------------------------XXXXXXXXXXXXXXXXXXX
