-----------------------------------------------------------------------------------------------------
-----------------------------------------------------------------------------------------------------
BBBBBBBBBBBBBBBBBBBBBPBBBBBBBBBBB--------------------------------------------------------------------
BBBBBBBBBBBBBB---------------------------------------------------------------------------------------
BBBBBBBBBBBBBB---------------------------------------------------------------------------------------
------------BB-CCCCCCC-------------BB------X---------------------------------------------------------
------------BB----------------------------XX-----------------------------------CCCCCCCCCCCCCCCC------
------------BB-BBBBBBB-------------------XXX---------------------------------------------------------
CCCCCCCCCCCCBB-BBBBBBB-------------------XXX---------------------------------------------------------
BBBBBBBBBBBBBB------------XXXXX---X------XXX------------------E-------------E------------------------
-------------------------EXXXXXXXXX------XXX--------------E--XX------------XX------------------------
-----------------------EXXXXXXXXXXXX-----XXX-B---------------XX------------XX------------------------
-E-E--E-E-E--E---------XXXXXXXXXXXXX-----XXX-b---------------XX------------XX------------------------
XXXXXXXXXXXXXXXXXXXXXXXXXXXXXXXXXXXXXXX--XXXXXXXXXXXXXXXXXXXXXXXXXXXXXXXXXXXXXXXXXXXXXXXXXXXXXXXXXXXX
