-----------------------------------------------------------------------------------------------------
-----------------------------------------------------------------------------------------------------
-----------------------------------------------------------------------------------------------------
-----------------------------------------------------------------------------------------------------
-----------------------------------------------------------------------------------------------------
BB---------------------------------------------------------------------------------------------------
-----------------------------------------------------------------------------------------------------
-----------------------------------------------------------------------------------------------------
B------------------------------------------------------CCCC----C-------------------E----------BB-----
-B----------------------------------E--------------------------------------------EXX-----------------
-----------------------------------XX-----------E-------------------------------XXXX--B----X--------E
-----------------------------------XX-------------------------------------------XXXX--b---XX-------XX
------------------EEE--------------XX--------------E---------------EEE--E-------XXXX--B-XXXX--BBBB-XX
XXXXXXXX-XXXXXXXXXXXXXXXXXXXXXXXXXXXXXXXXXXXXXXXXXXXXXXXX---XXXXXXXXXXXXXXXXXXXXXXXXXXXXXXXX-----XXXX
