--------------------------------------------------------------------------------------------------------------------
--------------------------------------------------------------------------------------------------------------------
--------------------------------------------------------------------------------------------------------------------
--------------------------------------------------------------------------------XXX---------------------------------
--------------------------------------------------------------------------------XX----------------------------------
--------------------------------------------------------------------------------XXXX--------------------------------
--------------------------------------------------------------------------------------------------------------------
--------------------------------------------------------------------------------------------------------------------
--------------------------------------------------------------------------------------------------------------------
--------------------B----------SXX--PB------------------------------------PB----------------------------------------
-------------------------------EEX----------------------------------------------------------------------------------
-------------------------------EEX--------------------------------------------------------SXX-----------------------
----------------C---------C----E---------C-------------------------------------C------C-C-EEX-----------------------
XXXXXXXXXXXXXXXXXXXXXXXXXXXXXXXXXXXXXXXXXXXXXXXXXXXXXXXXXXXXXXXXXXXXXXXXXXXXXXXXX----XXXXXXXXXXXXXXXXXXXXXXXXXXXXXXX
