-----------------------------------------------------------------------------------------------------
-----------------------------------------------------------------------------------------------------
-----------------------------------------------------------------------------------------------------
-----------------------------------------------------------------------------------------------------
X------------------------------------------------------------------------------E---------------------
-----------------------------------------------------E-------------------------E-------------BBBB----
----------------------------------------------------XX---------------------------CCCCCCCCC-----------
----------------------------------------------------XX-----------------------------------------------
----------------------------------------------------XXX-------------------------------------E--------
------------------------------------------------------------C---------------XX-----------------------
-----------------------------E---------------------------------------------XXX-----------------------
----------------------------XX-------------------------XX-----------------XXXX-----------------------
--------------EE------------XX-------------------------XXX----------------XXXX-----------------------
XXXXXXXXXXXXXXXXXXXXXXXXXXXXXXXXXXXXXXXXXXXXXXXXXXXXXXXXXXXXXXXXXX--XXXXXXXXX----XXXXXXXXXX------XXXX
