---------------------------------------------------------------------------------------------------------------------
---------------------------------------------------------------------------------------------------------------------
---------------------------------------------------------------------------------------------------------------------
---------------------------------------------------------------------------------------------------------------------
---------------------------------------------------------------------------------------------------------------------
--------------------------C-C--------C-----C---C---------------------------------------------------------------------
-----------------C---------C--C----CC-------C-------C--C----------------------C-C------------CCC--CC-----------------
------------C---C--------C-----C--C----C-CC--C-----C--C---CC---------------------------C----C---C--------------------
------C---C--CCC----------PPB-PPBBBBB-C-C-----PBBBC-----CC--C-C---C--C-CCCC-------C---C-C--C-------------------------
-------C---C----------CC---------------------------P------------C-----C-----C------C--------B------------------------
----------BBB------C-----B-------------------------------------C-C-------------------C-------------------------------
-----------------------------ES----SS-----E----EE---------------P-B---B-BBBPB------------------EEEEE-----------------
-----------------E--------XXXXXXXXXXXX---EXXXXXXXX---EE----EE-----------------S----------SS---XXXXXXXX---------------
------E----SE-XXXX-----EE-XXXXXXXXXXXXXXXXXXXXXXXXXXXXXXXXXXXX----------------XXXX----XXXXXXXXXXXXXXXX---------------
XXXXXXXXXXXXXXXXXX----XXXXXXXXXXXXXXXXXXXXXXXXXXXXXXXXXXXXXXXX----------------XXXX----XXXXXXXXXXXXXXXXXXXX-----------
