---------------------------------------------------------------------------------------------------------------------
---------------------------------------------------------------------------------------------------------------------
---------------------------------------------------------------------------------------------------------------------
---------------------------------------------------------------------------------------------------------------------
---------------------------------------------------------------------------------------------------------------------
------------------------------C---C-C-----C-----------C--CC---------------------------C---C--------------------------
----------------------C--C------C--C-------CCC----------C---C---------C------------C----------C----------------------
-----------------------C-------------C-CCC-------C------------C-----C--CCC------CC----------CC-C--C------------------
--------------------CC----C-C-BBB--B----------CC-----CP--------CCC-----BBB-----C--C-C-BPBBBPP---C--------------------
--------C--CCC--C-C----------C------------------C-----------------CC------C---------B--------------------------------
---------------C-----------C--------------------B--C----------------B------------------------------------------------
-------PBPBP-----------SE---B-E----EE----ES-------B-B-E----EE----------EE-P--------------EE--------------------------
XXXXXX----------------XXXX----XXXXXXXXXXXXXXXX--------XXXXXXXX---S----XXXX---------SE-XXXXXXXX-E------XXXX-----------
XXXXXX----------------XXXX----XXXXXXXXXXXXXXXX-EE-----XXXXXXXXXXXXE---XXXX----E---XXXXXXXXXXXXXXXXES--XXXX-----------
XXXXXX----------------XXXX----XXXXXXXXXXXXXXXXXXXX----XXXXXXXXXXXXXXXXXXXX----XXXXXXXXXXXXXXXXXXXXXXXXXXXX-----------
