---------------------------------------------------------------------------------------------------------------------
---------------------------------------------------------------------------------------------------------------------
---------------------------------------------------------------------------------------------------------------------
---------------------------------------------------------------------------------------------------------------------
---------------------------------------------------------------------------------------------------------------------
-----------------------------------------------------------------------------------CC-C--C---------------------------
--------------C--C------------------C----------------C-------C-------------------------CC---C--C---------------------
------------C--CC------C-----------C-C----------CC-C------CC----CC-CC-------------C--C-------C--C--------------------
--------C--C--B--B-C--------C---------------C-CC--B------C--------C--C----CC------B-B-BBBB-C--C--C-------------------
-------C--C--C--------C-C-CC---C-------C-C---C--BB-----C-------C--B-BP------CCC-------------------CC-----------------
------C----B------C-------------CC--------------------C--------BP------C-C-----CC------------------------------------
-----------------EP---------BBBBBB-EE-----PBBB-------E-----EE---------B------------E-E---E---------------------------
--------------XXXX----------------XXXX---------SS-XXXX----XXXX----E---------------XXXXXXXXE----S-S-------------------
-----------ES-XXXX-----SE---------XXXX---E----XXXXXXXX----XXXX---SXXXX------------XXXXXXXXXXXXXXXXEE--XXXX-----------
XXXXXX----XXXXXXXX----XXXX--------XXXXXXXX----XXXXXXXX----XXXXXXXXXXXX------------XXXXXXXXXXXXXXXXXXXXXXXX-----------
