---------------------------------------------------------------------------------------------------------------------
---------------------------------------------------------------------------------------------------------------------
---------------------------------------------------------------------------------------------------------------------
---------------------------------------------------------------------------------------------------------------------
---------------------------------------------------------------------------------------------------------------------
---------------C---------------C------------------------------------------------------------------CC-----------------
--------------C--------------C--CC----CC-----------------C-C---------------------------------------------------------
------C-C---------C--C-----C---------------------------C--C-C--------------------------C------CCC--------------------
-------------------C--C--C----BB-B--------C--C--C----C-------C--------C-CC--C-C---C--C---CCC-------------------------
----------C---------C--C----BB-----CC----------C----C-B-B------C------BPBPC------C-CC-C-C---C------------------------
-------BBP-CC---------------------C--C--------BP-B--------------C----------C-C--C------BBBBBBBBB---------------------
-----------------E------------E----------E--------B-BB------------B-PB-----------------------------E-----------------
--------------XXXX-----------EXXXX----XXXXE-----------E----EE----------SS-------------------------XXXX---------------
------E-------XXXXS-------XXXXXXXX----XXXXXXXX-SE-----XXXXXXXX--------XXXX---------ES----SE----ES-XXXXXXXX-----------
XXXXXXXXXX----XXXXXXXX----XXXXXXXX----XXXXXXXXXXXX----XXXXXXXX--------XXXX--------XXXXXXXXXXXXXXXXXXXXXXXX-----------
