--------------------------------------------------------------------------------------------------------------------
--------------------------------------------------------------------------------------------------------------------
--------------------------------------------------------------------------------------------------------------------
--------------------------------------------------------------------------------------------------------------------
--------------------------------------------------------------------------------------------------------------------
------------------BB-----------------------------------------------------BB---BB------------------------------------
--------------------------------------------------------------------------------------------------------------------
--------------------------------------------------------------------------------------------------------------------
--------------------------------------------------------------------------------------------------------------------
----------------PB------BB-P--------XX---XX---------------------------------------------------X---------------------
--------------------------------XX-XXX--XXX----------------------------------------------SXX-------X----------------
-------------------------------XXXXXX---XXX----------------------------------------------SEX------XXX---------------
-------------------------------XXXXXXX--XXX----------------------------------------------EEX------EXX---------------
XXXXXXXXXXXXXXXXXX---XXX---XXXXXXXXXXXXXXXXXXXXXXXXXXXXXXXXXXXXXXXXXXXXXXXXXXXXXXXXXXXXXXXXXXXXXXXXXXXXXXXXXXXXXXXXX
