---------------------------------------------------------------------------------------------------------------------
---------------------------------------------------------------------------------------------------------------------
---------------------------------------------------------------------------------------------------------------------
---------------------------------------------------------------------------------------------------------------------
---------------------------------------------------------------------------------------------------------------------
--------------------C-CC-------C---------C-----------------------------C------C--C-----------------------------------
------C-C-----C----C------------CC-------------------------------C----C-----------------------C--C-------------------
---------------------C--C---------------C-C--------------C--CCCCC-C-----C-----------------------C--------------------
----------CCCC-C-C----------C-BBBBCC---------------C--C-------------CCB--B-CCC----C----C---CCC-----C-----------------
----------B-BB--B--------------------------C---CC----C-CC-------BP-C------C----------C--C---B-----C------------------
-------------------------------------------------CC-C-------------BB-B---------------B-------------------------------
------E-----------E----ES-----E---PB-----S----BP---BBB-----------------EE------E------B-BB-----E---------------------
XXXXXXXXXX-SS----SXXXXXXXX----XXXX----XXXX-----------------ES----S----XXXX----XXXX--------E---XXXX-------------------
XXXXXXXXXXXXXXXXXXXXXXXXXX---EXXXX----XXXXE-----------S---XXXXXXXXE---XXXX----XXXX-SE-----XXXXXXXXE------------------
XXXXXXXXXXXXXXXXXXXXXXXXXXXXXXXXXX----XXXXXXXX--------XXXXXXXXXXXXXXXXXXXX----XXXXXXXX----XXXXXXXXXXXXXXXX-----------
