-----------------------------------------------------------------------------------------------------
-----------------------------------------------------------------------------------------------------
-----------------------------------------------------------------------------------------------------
-----------------------------------------------------------------------------------------------------
-----------------------------------------------------------------------------------------------------
--------------------------------------------------------------------BBB-----------B----BBB-----------
-E-----------------------------------------------E-----E---------------------------------------------
XXXX-------------------------------------------XXXXXXXXXXXXXX----------------C---E-------------------
----------C----------------------------------------------------BBBBB---------------------------------
------XXX------------C--------E-----BBBB------------------------------BBBBBBB--BPB-----BBB-----------
----------------X------------XX-----E--------XXX-----------------------------------------------------
---------------XX--B---------XX------------X---------------------------------------------------------
-----C--------XXX--b---------XX----------------------------------E------------------------------E----
-----X------XXXXXXXXXXXXXXXXXXXXXXXXXXXXX----------------------XXXXXXXXXXXXXXXXXXXXXXXXXXXXXXXXXXXXXX
