---------------------------------------------------------------------------------------------------------------------
---------------------------------------------------------------------------------------------------------------------
---------------------------------------------------------------------------------------------------------------------
---------------------------------------------------------------------------------------------------------------------
---------------------------------------------------------------------------------------------------------------------
----------------------------------C-C-C----------------------------------C-------------------------------------------
-------C----C-------------C--C-----C---CCC----------------------------C-C--------------------------------------------
-----------C-C--------CC-C------CC---C-------C-----------C----------------CC--CCCC-C------------C--------------------
--------C-C---C-CC---C--C-----BP-----B------C---C--C--------C-C---CC--BBPB--------C-CC------C--C---------------------
-------BBB---------C-------B-B----------------CC--BBBB--C--C-----------------C--------C-C--C--C----------------------
-----------------------B-B----------------------------B------C------------------------B-BBB--------------------------
------------------------------S----ES----S----PBB-------------------PB-EE-----E--------------------------------------
------S----SS----------------SXXXXXXXXXXXXE----------E-----------E----XXXX----XXXX-SE--------------------------------
XXXXXXXXXXXXXX----S----SS-XXXXXXXXXXXXXXXXXXXX----XXXXE-------XXXX----XXXX---SXXXXXXXX---SS----SEE-E-----------------
XXXXXXXXXXXXXX----XXXXXXXXXXXXXXXXXXXXXXXXXXXX----XXXXXXXX----XXXX----XXXXXXXXXXXXXXXXXXXXXXXXXXXXXXXX---------------
