---------------------------------------------------------------------------------------------------------------------
---------------------------------------------------------------------------------------------------------------------
---------------------------------------------------------------------------------------------------------------------
---------------------------------------------------------------------------------------------------------------------
---------------------------------------------------------------------------------------------------------------------
-------C------------------------------------------------------------------------------CC-C---------------------------
----------------------C-C---------------------C--C-----------------------------C------------C------------------------
--------C-----------CC-C-C---------C-CC-C----C------C---------------C---------C-------------------C------------------
-------------C--C---------C--C-CC-C---------------C-----CCCC-CC----C-CC-CC--CC-------CPBPP---------------------------
-----------CC-C------------BPB---C--C-----CCC--PB-BP-B-C----C----------------------CC-------P-C----------------------
-----------------C------------C-------------P-----------B--------C--------C--------------------C-C-------------------
------E---BBBBB--B-----ES-----BBP------------------------------PBB------------E------B---E----B----------------------
XXXXXXXXXX------------XXXX---S-----------------ES----E------------------------XXXX----XXXXE-------E------------------
XXXXXXXXXX--------E---XXXXXXXX-----SE----ES---XXXXXXXXE----SE-----E----EE-----XXXX----XXXXXXXX----XXXX---------------
XXXXXXXXXX--------XXXXXXXXXXXX----XXXXXXXXXXXXXXXXXXXXXXXXXXXX----XXXXXXXX----XXXX----XXXXXXXX----XXXX---------------
