--------------------------------------------------------------------------------------------------------------------
--------------------------------------------------------------------------------------------------------------------
--------------------------------------------------------------------------------------------------------------------
--------------------------------------------------------------------------------------------------------------------
--------------------------------------------------------------------------------------------------------------------
---------------BB-----P---------------------------------------------------------------------------------------------
--------------------------------------------------------------------------------------------------------------------
--------------------------------------------------------------------------------------------------------------------
--------------------------------------------------------------------------------------------------------------------
-----------------------------------XXX---XX----------------------------------BPB-B-----SXX---B------B---------------
---------------------------------XXXXX---XX--------------------------------------------EEX--------------------------
-------------------------------XXXXXX----XX--------------------------------------------EEX--------------------------
------------------------------XXXXXX-X--XXX------------------------------EX-C-C------C-EEX---------C----------------
XXXXXXXXXXXXXXXX--XX----------XXXXXXXX-XXXXXXXXXXXXXXXXXXXXXXXXXXXXXXXXXXXXXXXXXXXXXXXXXXXXXXXXXXXXXXXXXXXXXXXXXXXXX
