---------------------------------------------------------------------------------------------------------------------
---------------------------------------------------------------------------------------------------------------------
---------------------------------------------------------------------------------------------------------------------
---------------------------------------------------------------------------------------------------------------------
---------------------------------------------------------------------------------------------------------------------
--------C-------------C-CC------------------------------------------------------------C--C----CCC--------------------
-------C-----------C-C--------------------------C--------------CC------------C----C-CC--C----------------------------
---------------------------CCC-----------------C-C-C----------C----C-------C----C--C---C--C-C----C-------------------
--------PB----C-C---------BB-B--C--------C--CC--------C----------CC-CC--C-C-C------------B-C-C-----------------------
-------------------------------------C--------PBB---B--------C---PBB-B-----P--------------BBBP----CC-----------------
----------CC------------------P-BPC--------C-----------CC---C---------CC-C-------------------------------------------
------E---BBBB---------SS----E----------------------------------------BBP----------SS----E-----EE--------------------
XXXXXXXXXX--------S---XXXXXXXX-----------E-----SE----E-----------EE----------E----XXXXXXXXS---XXXX----XXXX-----------
XXXXXXXXXX--------XXXXXXXXXXXXE-------XXXX----XXXXXXXX--------XXXXXXXX----XXXXE---XXXXXXXXXXXXXXXX----XXXX-----------
XXXXXXXXXX--------XXXXXXXXXXXXXXXX----XXXX----XXXXXXXX--------XXXXXXXX----XXXXXXXXXXXXXXXXXXXXXXXX----XXXX-----------
