-----------------------------------------------------------------------------------------------------
-----------------------------------------------------------------------------------------------------
BBBBBBBBBBBBBBBBBBBBBBBBBBBBBBBBBBBBBBBBBBBB---------------------------------------------------------
BBBBBBBBBBBBBBBBBBBBBBBBBBBBB------------------------------------------------------------------------
BBBBBBBBBBBBBBBBBBBBBBBBBBBBB------------------------------------------------------------------------
BBBBBBBBBBBBBBBBBBBBBBBBBBBBB--------------------------BBBBB---BB---------------------X--------------
--------------------------------------------------------------------------------------------E--------
-----------------------------------------------------------------------------------------------------
P-------E--E--EE--------------------------------------------E----------------------------------------
PPBBBBBBBBBBBBBBBBBBBBBBBBBBB------------XXXX---E------------XX------------------E-X----------------E
--BBBBBBBBBBBBBBBBBBBBBBBBBBB-----------EXXXX--XX------------XX-----------------XX-------------------
--BBBBBBBBBBBBBBBBBBBBBBBBBBB---------EXXXXXX--XX---X--------XXX----------------XX-------------------
CCBBBBBBBBBBBBBBBBBBBBBBBBBBB---------XXXXXXX--XX--XX--------XXX-E------------E-XX-------------------
XXXXXXXXXXXXXXXXXXXXXXXXXXXXXXXX-----XXXXXXX---XXXXXXXXXX----XXXXXXXXXXXXXXXXXXXXX-----XXX-----XXXXXX
