--------------------------------------------------------------------------------------------------------------------
--------------------------------------------------------------------------------------------------------------------
--------------------------------------------------------------------------------------------------------------------
--------------------------------------------------------------------------------------------------------------------
--------------------------------------------------------------------------------------------------------------------
----------------B-BBBBBBPB------------------------------------------------------------------------------------------
--------------------------------------------------------------------------------------------------------------------
--------------------------------------------------------------------------------------------------------------------
--------------------------------------------------------------------------------------------------------------------
----------------------------------X-------------------------------------------P--P-P----------X--XX-----------------
----------------------------------XX---XX----------------------------------------------------XXX-XX-----------------
-----------------------------SXX-XXXX-XXX------------------------------------------------SXXXXXXXXXX----------------
-------------------------C---EEXXXXX-XXXX-------------------------------------C----------EEXXXXXXXXXX---------------
XXXXXXXXXXXXXXXXXXXXXXXXXXXXXXXXXXXXXXXXXXXXXXXXXXXXXXXXXXXXXXXXXXXXXXXXXXXXXXXXXXXXXXXXXXXXXXXXXXXXXXXXXXXXXXXXXXXX
