--------------------------------------------------------------------------------------------------------------------
--------------------------------------------------------------------------------------------------------------------
--------------------------------------------------------------------------------------------------------------------
--------------------------------------------------------------------------------------------------------------------
--------------------------------------------------------------------------------------------------------------------
---------------------------------------------------------------------------------------------------B----------------
--------------------------------------------------------------------------------------------------------------------
--------------------------------------------------------------------------------------------------------------------
--------------------------------------------------------------------------------------------------------------------
------------------------B----------------------------------------------------BBBPB--P--PB----BB---------------------
--------------------------------------------------------------------------------------------------------------------
-----------------------------------------XX-------------------------------------------------------------------------
-----------------------------------------XX-------------------------------C---------C--------------C----------------
XXXXXXXXXXXXXXXXXX----XX------X---XX----XXXXXXXXXXXXXXXXXXXXXXXXXXXXXXXXXXXXXXXXXXXXXXXXXXXXXXXXXXXXXXXXXXXXXXXXXXXX
