---------------------------------------------------------------------------------------------------------------------
---------------------------------------------------------------------------------------------------------------------
---------------------------------------------------------------------------------------------------------------------
---------------------------------------------------------------------------------------------------------------------
---------------------------------------------------------------------------------------------------------------------
------------------------------------C-------------------------C---------------------C--------------------------------
---------------------C--------C--CC--C----------C----------------C-C-------------------C-------CC--------------------
-------C----C-----CC---------------C-------C-------CC--CCC--------------C-C----C--C--C--C--------CC------------------
---------BCC---C---------------C--BPB-----C-CC-C--C--------------B--C-------C-C-C-----C-----C------------------------
----------B---C--------C-C-CC-BBBP----C---------BB----C-----------PBBB-------C---C----BPPB-C-------------------------
----------------CC----C------C-----------C--------B--BB---------------B-B--------------------C-----------------------
------E-------P------------PPB-----EE----------------------------E-----------------EE-----P--------------------------
XXXXXXXXXX-ES-----E-----------E---XXXX---------SS-------------XXXXS---------------XXXX---E-----S-EE------------------
XXXXXXXXXXXXXX----XXXX--------XXXXXXXX----E---XXXX---ES-------XXXXXXXX-ES----SS---XXXXXXXX----XXXXXXXX---------------
XXXXXXXXXXXXXX----XXXX--------XXXXXXXX----XXXXXXXXXXXXXXXX----XXXXXXXXXXXXXXXXXXXXXXXXXXXX----XXXXXXXXXXXX-----------
