-----------------------------------------------------------------------------------------------------
--------------------------------XX-------------------------------------------------------------------
-----------------------------------------------------------------------------------------------------
-----------------------------------------------------------------------------------------------------
-----------------------------------------------------------------------------------------------------
-------------------BBBBBB---------------------------XXXX-----------------------BBBBBB----------------
E--------------------------------------CCC----------XXXX---------------------------------------------
---------------------------------------------------XXXXX---------------------------------------------
---------------------------------------------------XXXXX---------E----------X------------------------
---------------BBBPB-------------------------------XXXXX--------XX--XX-------------------------------
------E-----------------------XX-------------------XXXXX--------XX--XX-------------------------------
-----XXXX--------------------XXXXX-----------------XXXXX--------XX--XX------------------B------------
-----XXXX---------E---------XXXX---------------E---XXXXX-----EE-XX--XX----XX------------b------------
----XXXXXXXXXXXXXXXXXX-----XXXX----XXXXXXXXXXXXXXX-XXXXXX--XXXXXXXXXX--------XXXX----XXXXXXXXXXXXXXXX
