---------------------------------------------------------------------------------------------------------------------
---------------------------------------------------------------------------------------------------------------------
---------------------------------------------------------------------------------------------------------------------
---------------------------------------------------------------------------------------------------------------------
---------------------------------------------------------------------------------------------------------------------
---------------C----------------------C------------------------------------------------------------------------------
--------------C---C-C-----------------------------------C-------------------------------------C---CC-----------------
-------CC-------CC-C-C-C-C----C----C-C------C-C------CC--C-------CC-----------C----C-----------C-C-------------------
----------C-------------C-------C-C-C-----C--C----C----------------C------C--C----C---------CC--C--------------------
------C----CC------------B-C----------------BB-CCC--C--------C--C-----CC-C------------C----C--B----------------------
------BB-B---C------------C---BBB-------------B-BBBB--------C--------B--C--CC------------CC--------------------------
----------BBP----E----------BB-----------E----------------------------PBBBBBB----------BBBPBP------------------------
--------------XXXXE----SE----------EE-XXXXE-----------E------------------------E---------------E-E-S-----------------
------E-------XXXXXXXXXXXX----S---XXXXXXXXXXXX-EE----SXXXX-------EE-----------XXXX-EE---------XXXXXXXX---------------
XXXXXXXXXX----XXXXXXXXXXXX----XXXXXXXXXXXXXXXXXXXXXXXXXXXX----XXXXXXXX--------XXXXXXXX--------XXXXXXXXXXXX-----------
