---------------------------------------------------------------------------------------------------------------------
---------------------------------------------------------------------------------------------------------------------
---------------------------------------------------------------------------------------------------------------------
---------------------------------------------------------------------------------------------------------------------
---------------------------------------------------------------------------------------------------------------------
------------C----------C---------------------------------------------------------------------------------------------
---------C---CC----------C--------C--C-------C-----C-C-------C--------CC--CCC----------------------C-----------------
--------C--C----CC----C-C--C-CC--C--------C-C--C--C-----C-C-------------C-----------CC-C-----------------------------
------C----BBB----C-------C-C----------C------C-C---C-C----C----CC-----------------C----CC---C----C------------------
---------------------C--------BPP--------C-B-P-B--PB---C-C----CC------BB----------C---C---C-C---CC-------------------
--------------------------PBBP------------------------------------C-----------C----PB-BPB-B---C----------------------
-----------E-S---------ES--------------------------------------BBPBP-------------------------------------------------
------E---XXXX---E----XXXX----E----E-S----E----EE----E-----ES----------E-E---E--------------------E------------------
XXXXXXXXXXXXXXXXXXS---XXXX---EXXXXXXXX---EXXXXXXXXXXXXE---XXXX--------XXXXXXXX-----EE----SS-------XXXX---------------
XXXXXXXXXXXXXXXXXXXXXXXXXXXXXXXXXXXXXXXXXXXXXXXXXXXXXXXXXXXXXX--------XXXXXXXX----XXXXXXXXXXXX----XXXX---------------
