-----------------------------------------------------------------------------------------------------
-----------------------------------------------------------------------------------------------------
-----------------------------------------------------------------------------------------------------
-----------------------------------------------------------------------------------------------------
------------------------------------------------------------------------------CC---------------------
---------------------------B-------------------B-----------------------------------------------------
-E--------------------------------------------------------------------------------X------C-----------
XX---------------------------------------------------------------------------------------------------
XX----------------------------E----------------------------------------------------------------------
XXX-----------XX-----------B-XX----------------B-------B----------------------------------------E--E-
------------EXXX-------------XX--------------E-------------------------------------------------XX-XX-
----------X-XXXX-------------XX-------------XX---------------------------------XXXXXXX---------XX-XX-
---------XXXXXX--------------XX----------E--XX-------------------------E-----------------------XX-XX-
XXXXXXX-XXXXXXX--XXX--XXXXXXXXX-XXXXXXXXXXXXXXXXXXXXXXXXXXXXXXXXXXXXXXXXXXXXX------------XXXXXXXX-XXX
