---------------------------------------------------------------------------------------------------------------------
---------------------------------------------------------------------------------------------------------------------
---------------------------------------------------------------------------------------------------------------------
---------------------------------------------------------------------------------------------------------------------
---------------------------------------------------------------------------------------------------------------------
----------------------------CC----CCC-----CC-----------------C---------------C---------------------------------------
--------------C--C-------C------C-----------CCC-C----------------C--------C----------C------------C------------------
----------------------CC-------------C---C--------C---CC--C-----C------CC-----------------------CC-C-----------------
-------BBB--C--C----C-----BBB-BBB----------------C---CPB--------------------------C-C-------C-CC---------------------
----------C---B----C-----P------------CCC-----BB-PP-BB-------------------C----------B-----CC-C-----------------------
-------------------------------------------------------------------C--BPB------CCC-----C-----------------------------
------E---P-B----------------EE----EE-----S-----------E----SE------BPP-------S--------PPBB---------------------------
XXXXXXXXXX-------E-----EE-XXXXXXXXXXXX----XXXX-SS----SXXXXXXXX---E--------XXXX-----ES----------EEEXXXXXXXX-----------
XXXXXXXXXX----XXXXS---XXXXXXXXXXXXXXXX---SXXXXXXXXXXXXXXXXXXXXXXXX-----SE-XXXX----XXXX--------XXXXXXXXXXXX-----------
XXXXXXXXXX----XXXXXXXXXXXXXXXXXXXXXXXXXXXXXXXXXXXXXXXXXXXXXXXXXXXX----XXXXXXXX----XXXX--------XXXXXXXXXXXX-----------
