-----------------------------------------------------------------------------------------------------
-----------------------------------------------------------------------------------------------------
-C-------BBBBBBBBBBBBBBBBBBBBBBBBBBBBBBBBBBBBBBBBBBBBBBBB--------------------------------------------
XXX----------------BBBB----------BBB----------------------------------------E---E--------------------
-------------------BBBB----------BBB--------------------------------X------XXXXXXXXXXXX--------------
----------BB----------------------BB-----E-----------------------------------------------------------
----------------------------------BB----XX-----------------------------------------------------------
----------------------------------BB----XX----------------------------XXXXX------------------X-------
--------------------E-------------BB----XX-------------------X---------------------------------------
----------BB--E----BBBB------E----BB--BBXXBBB---BBB---------EX--E----------------------------------XX
-------------XX---EE--------XX----------XX--------------XX-XXX-XX---------------------------------XXX
X------------XX-------------XX----------XX-------------XXXXXXX-XX--------------------------------XXXX
-------------XX-------------XX-----E-E--XX--------EE--XXXXXXXX-XX------------------------E-EE-E--XXXX
-----XXXXXXXXXXXXXXXXXX-XXXXXXXXXXXXXXXXXXXXXXXXXXXXXXXXXXXXXXXXX-----------------------XXXXXXXXXXXX-
