---------------------------------------------------------------------------------------------------------------------
---------------------------------------------------------------------------------------------------------------------
---------------------------------------------------------------------------------------------------------------------
---------------------------------------------------------------------------------------------------------------------
---------------------------------------------------------------------------------------------------------------------
------------------------------------C-----C-----------C--------------------------------------------------------------
----------C--C----C-CC------------------CC--------C----C------------------C---------------CCC------------------------
--------------C-C--C-----------------CCC---CC-C----CC---C---------CC-------------------C-----------------------------
------C-C-BBPB-C-------CCC------C------------B--C-----PBB---C-------C---C---C-------C---C----------------------------
---------------BPB--------C--------------------C-CP--P---------C---B------P-------C---C--C-B----CC-------------------
-------C-C------------------------------------B-B---------C---C-------C-----------------BB----CC---------------------
---------B-ES-----E-----------BBPP-ES----SE-----------E---------------BBBB----S-------------------SE-----------------
XXXXXX----XXXX---EXXXX------------XXXXXXXXXXXX-------EXXXX--------E----------EXXXX--------S-------XXXX---------------
XXXXXX----XXXXXXXXXXXX-EE----S----XXXXXXXXXXXX-SE-XXXXXXXX--------XXXX----XXXXXXXX-ES----EXXXX----XXXX---------------
XXXXXX----XXXXXXXXXXXXXXXXXXXX----XXXXXXXXXXXXXXXXXXXXXXXX--------XXXX----XXXXXXXXXXXXXXXXXXXX----XXXXXXXX-----------
