---------------------------------------------------------------------------------------------------------------------
---------------------------------------------------------------------------------------------------------------------
---------------------------------------------------------------------------------------------------------------------
---------------------------------------------------------------------------------------------------------------------
---------------------------------------------------------------------------------------------------------------------
-------------------------------------------C-------C-------C------C-----------C------------------C-------------------
----------C----------------------------------C----C-C--------C------CC--CC-------CC---C------------C-----------------
------C----------CC--------------C----C-----C--------------------------C----CC------CC---C----CC---------------------
-------C-----C-C--------CC---C-C--C----C---------CBBP---C-----C--CBBBPPPBB-------------C--CC-C-----------------------
--------C-P---C-C-----C-----C--PB--BBBB-------C--------C-------------------C--------PBPBPP--C------------------------
-------BBB---------------BCC-------------------CC--------------CC---------B----------------P-------------------------
--------------------------BB--------------E----------S-----EE----BE----ES-----S----------------SE--------------------
-----------SE-----------------S----ES----EXXXX----XXXX----XXXX----XXXXXXXX----XXXX-ES----S----XXXX-E-----------------
------E---XXXX---ES----EE-----XXXXXXXXXXXXXXXX----XXXX----XXXX----XXXXXXXX---EXXXXXXXXXXXXE---XXXXXXXX---------------
XXXXXXXXXXXXXXXXXXXXXXXXXX----XXXXXXXXXXXXXXXX----XXXX----XXXX----XXXXXXXXXXXXXXXXXXXXXXXXXXXXXXXXXXXXXXXX-----------
