---------------------------------------------------------------------------------------------------------------------
---------------------------------------------------------------------------------------------------------------------
---------------------------------------------------------------------------------------------------------------------
---------------------------------------------------------------------------------------------------------------------
---------------------------------------------------------------------------------------------------------------------
------------------------------CC-C------------CC---------------------------------------------------C-----------------
-------------C---------C---C-C--------------------C------C-----------C----C---------CC-----CC-----C------------------
----------C-------CC--C-C-----------------------CC--C-C-------C---------------------------C---C-CC-------------------
------C-C---C------------BC----B---C----------B--B---C-CC---CC-C-----P-C-C--C-C---------C-B--------------------------
----------B-BBC-C---C-----BBBB--------------C-----P-BB-----C-----C------C----------BB--C-----------------------------
---------------C-C-------------------C----CC-C------------------------C----------------------------------------------
---------P----BBB------EE-----S----------S--BB-SE-----------------S---PBBB------------B---S-------SS-----------------
-----------EE---------XXXX---EXXXX----XXXX----XXXX---EE-----------XXXX-------ES----SE-----XXXX-EEEXXXX---------------
XXXXXX----XXXX----S---XXXXXXXXXXXX----XXXX----XXXXXXXXXXXX-------EXXXX----XXXXXXXXXXXX----XXXXXXXXXXXXXXXX-----------
XXXXXX----XXXX----XXXXXXXXXXXXXXXX----XXXX----XXXXXXXXXXXX----XXXXXXXX----XXXXXXXXXXXX----XXXXXXXXXXXXXXXX-----------
