---------------------------------------------------------------------------------------------------------------------
---------------------------------------------------------------------------------------------------------------------
---------------------------------------------------------------------------------------------------------------------
---------------------------------------------------------------------------------------------------------------------
---------------------------------------------------------------------------------------------------------------------
--------------------------C--C---------------------------------------------------------------------------------------
-------C-----C--------------C-C-CC--------------------------------C-----------CC---------C---------------------------
---------C-C---------------C----------------------C----------------C------------C--C-------C-------------------------
----------C-C---C----C-C---BBP-C------------C------C--C-C--C----C--P-P-C----CC------CC-C--------C-CC-----------------
------BPBB----CC------C-CC----BB-BC-C-C---CC-C-BBBPBBB-------C---C---------C---------P-BBP---CCC---------------------
-------------------CC--------------C-C-C--------------B---C---C----------------------------BBB---C-------------------
-----------------------------E----B-------------------------------S---BBPBP---E--------------------------------------
------E----SE-------------XXXXE----------------E-S---E------------XXXX--------XXXX-EE----E------------XXXX-----------
XXXXXXXXXXXXXX---S-----EE-XXXXXXXX--------E---XXXXXXXXS-----------XXXX--------XXXXXXXXXXXXE-----------XXXX-----------
XXXXXXXXXXXXXXXXXX----XXXXXXXXXXXX--------XXXXXXXXXXXXXXXX--------XXXX--------XXXXXXXXXXXXXXXX--------XXXX-----------
