--------------------------------------------------------------------------------------------------------------------
--------------------------------------------------------------------------------------------------------------------
---------------------------------------------------------------------------------X----------------------------------
--------------------------------------------------------------------------------XX----------------------------------
--------------------------------------------------------------------------------XX----------------------------------
-------------------------------------------------------------------------------XXXXX-----BBB---BBB------------------
--------------------------------------------------------------------------------------------------------------------
--------------------------------------------------------------------------------------------------------------------
--------------------------------------------------------------------------------------------------------------------
-----------------------P-P-----------XX------------------------------------------------P----B-----------------------
--------------------------------X----XX---X-------------------------------------------------------------------------
-------------------------------EX----XX--X---------------------------------------------SX---------------------------
-----------------------C-------E--XXXXXXXXX--------------------------------------------E------------C---------------
XXXXXXXXXXXXXXXXXXXXXXXXXXXXXXXXXXXXXXXXXXXXXXXXXXXXXXXXXXXXXXXXXXXXXXXXXXXXXXXXXXXXXXXXXXXXXXXXXXXXXXXXXXXXXXXXXXXX
