-----------------------------------------------------------------------------------------------------
-----------------------------------------------------------------------------------------------------
-----------------------------------------------------------------------------------------------------
-----------------------------------------------------------------------------------------------------
-----------------------------------------------------------------------------------------------------
-----------------B----------------------------------------------BBBBBB---------------BBBBBBBBB-------
---------------------------------XXXXXX--------------------------------------------------------------
---------------------------------C-------X-------------------------------------------------------E---
B-----------------------------XX---------X---------B-----------B--------------------------------XX---
----B------------B-----------XXX---------X-------------------------E----XXXXXX----BB----B---E---XX---
-----------------------E-----XXX---------X-------------------------------------------------XX---XX---
-----------------------------XXX---------X-------------------------------------------------XX---XX---
---EE-E-EE------------------EXXX---------X-------------------X-----------------------------XX---XX---
XXXXXXXXXXXXXXXXXXXXXXXXXXXXXXX----------X--XXXXXXXXXXXXXXXXXXXXXXXXX----------XXXXXXXXXXXXXXXX-XXXXX
