-----------------------------------------------------------------------------------------------------
-----------------------------------------------------------------------------------------------------
------BBBBBBBBBBBBBBBBBBBBBB-------------------------------------------------------------------------
-----------------------------------------------------------------------------------------------------
-----------------------------------------------------------------------------------------------------
---E----------------------------XX-------------------------------------------------------------------
XXXXX---------------------------XX-----------------------------------------------------------------C-
--------------------------------XX-------------------------------------------------------------------
--------------E-----------------XX--------------XBB--------------------------------------------CC----
-------------XX------------XX---XX---------X---XXX--------------BB-------X---------------------------
----------E--XX-----------XXX---XX--------XX--XXXX----------------------XX---------------------------
X--------XX--XX---------EXXXX-------------XXXXXXXX---XX----------------XXXX--------------------------
---------XX--XX-E----EE-XXXXX-------------XXXXXXXX---XX-E-------------XXXXX--E-----------------------
--------XXXXXXXXXXXXXXXXXXXX---XXXXXXXXXXXXXXXXXX---XXXXXXXXXXXXXXXXXXXXXXXXXXXXXXXXXXXXXXXXXXXXXXXXX
