--------------------------------------------------------------------------------------------------------------------
--------------------------------------------------------------------------------------------------------------------
--------------------------------------------------------------------------------------------------------------------
--------------------------------------------------------------------------------------------------------------------
--------------------------------------------------------------------------------------------------------------------
----------------B-BBBBBBPBP-----------------------------------------------------------------------------------------
--------------------------------------------------------------------------------------------------------------------
--------------------------------------------------------------------------------------------------------------------
--------------------------------------------------------------------------------------------------------------------
------------------------B-----------X--------------------------------------------------P--SXX-----------------------
-------------------------------SXX--X---XX------------------------------------------------EEX-----------------------
-------------------------------EEX-XX---XXX------------------------------X----------------EEX-----------------------
-------------------------C-C---EEX-XX---XXX-------------------------------X-----------C---EEX-----------------------
XXXXXXXXXXXXXXXXXXXXXXXXXXXXXXXXXXXXXXXXXXXXXXXXXXXXXXXXXXXXXXXXXXXXXXXXXXXXX-XXXX--XXXXXXXXXXXXXXXXXXXXXXXXXXXXXXXX
