--------------------------------------------------------------------------------------------------------------------
--------------------------------------------------------------------------------------------------------------------
--------------------------------------------------------------------------------------------------------------------
--------------------------------------------------------------------------------------------------------------------
--------------------------------------------------------------------------------------------------------------------
----------------------------------------------------------------------------BBBB------------------------------------
--------------------------------------------------------------------------------------------------------------------
---------------------------------------------------------------------------C----------------------------------------
--------------------------------------------------------------------------------------------------------------------
-------------------------------------XXX----------------------------------BB------B---------------------------------
-------------------------------------XX-----------------------------------------------------------------------------
------------------------------------XXX-----------------------------------------------------------------------------
---------------------------------XXXXXXX--C------------------------------------C------------------------------------
XXXXXXXXXXXXXXXXXXXXXXXXXXXXXXXXXXXXXXXXXXXXXXXXXXXXXXXXXXXXXXXXXXXXXXXXXXXXXXXXXXXXXXXXXXXXXXXXXXXXXXXXXXXXXXXXXXXX
