--------------------------------------------------------------------------------------------------------------------
--------------------------------------------------------------------------------------------------------------------
--------------------------------------------------------------------------------------------------------------------
--------------------------------------------------------------------------------------------------------------------
--------------------------------------------------------------------------------------------------------------------
-----------------------------------------------------------------------------------------BBB----B-------------------
--------------------------------------------------------------------------------------------------------------------
--------------------------------------------------------------------------------------------------------------------
--------------------------------------------------------------------------------------------------------------------
--------------------PB-------BBSX--B-B---------------------------------------------------------XXXX-----------------
------------------------------EEX------------------------------------------------------------XXXX---X---------------
------------------------------EEX------------------------------------------------------------XXXXX-XX---------------
---------------EX-C-C---C--C---EX--------C-------------------------------------------------XXXXXXXXXX---------------
XXXXXXXXXXXXXXXXXXXXXXXXXXXXXXXXXXXXXXXXXXXXXXXXXXXXXXXXXXXXXXXXXXXXXXXXXXXXXXXXXXXXXXXXXXXXXXXXXXXXXXXXXXXXXXXXXXXX
