---------------------------------------------------------------------------------------------------------------------
---------------------------------------------------------------------------------------------------------------------
---------------------------------------------------------------------------------------------------------------------
---------------------------------------------------------------------------------------------------------------------
---------------------------------------------------------------------------------------------------------------------
--------------------------C------C--------------------------------------C--------------------------------------------
---------C----CC-----C------C---C-----------------------C-------------------C------C-------------C-------------------
------C----C----C-C----------C-C---------C----C-------------C-C-C-C--C-C-C---C--C----CC------C--C-C------------------
------PBPBP------C--C---C--PBBB---C----C--------C--C-CC------C-----C--B---C--------BB--CCC---------------------------
-----------------------C-----------CC------------C-------------------------------C----BB-B--C------------------------
----------------------BBB-----------------CC-C-BBB----------------P-BB-----------------------------------------------
------E----EE----------------EE-----------BPBB----BB-------------E-----EE----------ES--------------------------------
XXXXXXXXXXXXXX---ES-------XXXXXXXX-------S------------S----S-SXXXX----XXXX---E----XXXX---S-----ESE-------------------
XXXXXXXXXXXXXXXXXXXXXX-ES-XXXXXXXX-SS-XXXX-----EE-----XXXXXXXXXXXXE---XXXXXXXXS---XXXXXXXXE---XXXX-E--XXXX-----------
XXXXXXXXXXXXXXXXXXXXXXXXXXXXXXXXXXXXXXXXXX----XXXX----XXXXXXXXXXXXXXXXXXXXXXXXXXXXXXXXXXXXXXXXXXXXXXXXXXXX-----------
