-----------------------------------------------------------------------------------------------------
-----------------------------------------------------------------------------------------------------
BBBBBBBBBBBBBBBBBBBBBBBBBBBBBBBBBBBBBBBBBBBBBBBBBBBBBBBBBBBBBBBBBBBBBBBBB----------------------------
-----------------------------------------------BBBBBBBBB---------------------------------------------
P----------------------------------------------BBBBBBBBB---------------------------------------------
PP----E-----------------B----------------------BBBBBBBBB---------------------------------------------
-----XX-----------------B----------------------------------------------------------------------------
-----XX-----------------B----------------------------------------------------------------------------
-----XX-----------------B--------------------------P----------------------------------------------E--
BBBBBXXB----------------B------------------------BBPPBBB---E-------------------------------------XX--
-----XX---------------------XX-B-----------------B---BBB--XX----------BBB------------------------XX--
-----XX-------------------EXXX-B------X----------B---BBB--XX----------BBB------------------------XX--
-----XX-------------------XXXX-B------X-----------CCCBBB--XX-----E----BBB--E------E--X-E---E---E-XX-E
XXXXXXXXXXXXXXXXXXXXX--XXXXXX--X---XXXXXXXX-----XXXXXXXXXXXXXXXXXXXX--XXXXXXXXXXXXXXXXXXXXXXXXXXXXXXX
