---------------------------------------------------------------------------------------------------------------------
---------------------------------------------------------------------------------------------------------------------
---------------------------------------------------------------------------------------------------------------------
---------------------------------------------------------------------------------------------------------------------
---------------------------------------------------------------------------------------------------------------------
--------C---------C-------------C----------C--------------------------C-C--------------------------------------------
-------C-C----CC-----C-C--------------------CC----C--------------------C----------------------CC-C-------------------
------C----CC---C--CC------------C-----C-CC-----------------------CC-----C------------C----C-------------------------
-------BB----C---C--------C---BBB--C-C-------BC--C--CC-C-C-C----C---B-P-B------CC-CC---C----C---C--C-----------------
----------C------------------B--------C--------C--BBBB--C-----C-----------C-CC------CC--C----------------------------
----------BB----------------------C-----------BB-P----B------C----------------C-------PBBBBP-------------------------
------E-----------S----EE-----S---B-------E-----------------------S----EE--P-------BB--------------------------------
XXXXXXXXXX-------EXXXXXXXX---EXXXX--------XXXX-------E------------XXXXXXXX---------------------E-E----XXXX-----------
XXXXXXXXXX-ES-XXXXXXXXXXXXXXXXXXXX-------SXXXX-EE-XXXXE-----------XXXXXXXX---------------EE---XXXX-E--XXXX-----------
XXXXXXXXXXXXXXXXXXXXXXXXXXXXXXXXXX----XXXXXXXXXXXXXXXXXXXX--------XXXXXXXX------------XXXXXXXXXXXXXXXXXXXX-----------
