-----------------------------------------------------------------------------------------------------
-----------------------------------------------------------------------------------------------------
----------------------------------------C------------------------------------------------------------
-----------------------------------------------------------------------------------------------------
E-----------------------------------------X----------------------------------------------------------
BBPBB------------------XX----------------------------------------------------------------X--XXXXX----
----------------------XXX----------------------------------------------------------------------------
-------------------XXXXXX----------------------------------------------------------------------------
-------------------XXXXXX------------XXXXX---------------------------C------BBBB---------------------
BBBBB-------------XXXXXXX---------------------------------------------------------BPB--XXXX----------
-----------------XXXXXXXX---------------------E----B--------------------X----------------------------
---------B------XXXXXXXXX--------------------XX----b--------------------X----------------------------
---------b------XXXXXXXXX-------EE---C-------XX----B---EE---------------X----------------------------
XXXXXXXXXXXXXXXXXXXXXXXXXXXXXXXXXXXXXX-----XXXXXXXXXXXXXXXXXXXXXXXX-----XXX-XXXXXXXXXX-----------XXXX
