-----------------------------------------------------------------------------------------------------
-----------------------------------------------------------------------------------------------------
-----------------------------------------------------------------------------------------------------
-----------------------------------------------------------------------------------------------------
--------------------------C--------------------------------------------------------------------------
--------------------BBB---------------------------------BBB-----------------B-----------BB-----------
-----------------------------------------------------------------------------------------------------
--------------------------------------------------------------------------------------------------C--
-------------------B------------------------------E------E-----------------------BBBBBBB-----------E-
-X-----------------------------------------------XX-----BBB---C-----------BBBB-------------------BBBB
-------------------------------------------------XX--------------------------------------------------
---E---------------------------------------------XX-------------------------------------------------E
C----EE--E-------E--------E----------------E-----XX--E-E------------------E--------------------------
X--XXXXXXXXXXXXXXXXXX--XXXXXXXXXXXXXXXXXXXXXXXXXXXXXXXXXXXXXXXXXXXXXXXXXXXXXXXXXXXXXXXXXXXXXXXXXXXXXX
