---------------------------------------------------------------------------------------------------------------------
---------------------------------------------------------------------------------------------------------------------
---------------------------------------------------------------------------------------------------------------------
---------------------------------------------------------------------------------------------------------------------
---------------------------------------------------------------------------------------------------------------------
----------------------------------C--------C-C--------------------CC---C---------C-----------------------------------
------------------------------------C-------C---------------------------C----C-C-------------------------------------
------------CC---C--------------CC-------CC----CCC-----------CC-C---CC---C--C---------------CCC-C--------------------
--------C-BBP-C----C--C--------B-BBB--C-C---------CCCC--C-CC------BBB-BB-P--------CC-C-C---C---C---------------------
----------------C------C----C-----------------C---BP---------------------------------------------CC------------------
--------------PB----CC--CCBBP--------------------B----CC----------------------------C--------------C-----------------
-----------EE------------B----E----SS-----E-----------BPP--------SS----EE-----E------PBBPB---------------------------
XXXXXX----XXXX----------------XXXXXXXX----XXXX------E------SE-XXXXXXXXXXXX---EXXXX-----------------------------------
XXXXXX----XXXX---E-----------EXXXXXXXX---EXXXX-EE-XXXX----XXXXXXXXXXXXXXXXXXXXXXXX--------E----SEE-------------------
XXXXXX----XXXXXXXX--------XXXXXXXXXXXXXXXXXXXXXXXXXXXX----XXXXXXXXXXXXXXXXXXXXXXXX--------XXXXXXXX-------------------
