--------------------------------------------------------------------------------------------------------------------
--------------------------------------------------------------------------------------------------------------------
--------------------------------------------------------------------------------------------------------------------
--------------------------------------------------------------------------------------------------------------------
--------------------------------------------------------------------------------------------------------------------
-------------------------------------------------------------------------B-----BB-----------------------------------
--------------------------------------------------------------------------------------------------------------------
--------------------------------------------------------------------------------------------------------------------
--------------------------------------------------------------------------------------------------------------------
------------------------------------XXX--XX--------------------------------------------SX----B----------------------
--------------------------------XX--XX---XX--------------------------------------------EX---------------------------
--------------------------------XXXXXX---XX--------------------------------------------E----------------------------
--------------------------------XXXXXX--XXX---------------------------------------C----E----------------------------
XXXXXXXXXXXXXXXXXX----X-----------XXX---XXXXXXXXXXXXXXXXXXXXXXXXXXXXXXXXXXXXXXXX--XXXXXXXXXXXXXXXXXXXXXXXXXXXXXXXXXX
