-----------------------------------------------------------------------------------------------------
-----------------------------------------------------------------------------------------------------
--------E--------------------------------------------------------------------------------------------
-----------------------------------------------------------------------------------------------------
----------------------------------------------------------------------------------------------------X
--------------------------BBBBB--------------E---XXXX-----------------------------------B------------
-----------------------------------E------------XXXXX------------------------------------------------
------------------------X---------XX----C------XXXXXX------------------------------------------------
----------------------------------XX-----E---EXXXXXXX------------------------------------------------
------------------------------B---XX---BBBB-XXXXXXXXX-------------------E------X--------B------------
----------------------------------XX--------XXXXXXXXX------------------XX-----XX---------------------
X----------X----------------------XX------E-XXXXXXXXX------------------XX----XXX-------------E-------
X-------XXXX----------------------XX--------XXXXXXXXX--------XX--X-EE--XX---XXXX-E-------------------
XXXXXXXXXXXXXXXXXXXXXX--XXXXXXXXXXXXXXXXXXXXXXXXXXXXXXXXXXXXXXXXXXXXXXXXXX-XXXXXXXXXXXXXXXXXXXX-XXX--
