-----------------------------------------------------------------------------------------------------
-----------------------------------------------------------------------------------------------------
---------------------------B----------------P------------------------BBBBBBBBBBBBBBBBBBB-------------
---------------------------B-------------------------------------------------------------------------
CCC----CCCCCCCCCCC---------B-------------------------------------------E-----------------------------
---------------------------B--PBBB------------XX------------BBBBBBBBB--BB------------E---------------
---------------------------B-------------------------------------------BB-----------XX---------------
--------------XX-----------B-------------------------------------------BB-----------XX-----------X---
---------------------------B--------BBBBBBBB---------------------------BB-----------XX----CC----XX--E
----------------------E----B---------------------------------E----BBB--BB-----E-----XXBB------XXXX-XX
---------------------XX----B---B----------------------------XX---------------XX-----XX-------XXXXX-XX
-----------------XXX-XX----B---b----------------------------XX---------------XX-----XX-------XXXXX-XX
EEE------------------XX----B---B-----------------------E----XX----E----------XX-----XX-------XXXXX-XX
XXXXXX-XXXXXXXX------XXXXXXXXXXXXXXXXXXXXXXXX---XXXXXXXXXXXXXXXXXXXXXXXXXXXXXXXXXXXXXXXX---XXXXXXXXXX
