-----------------------------------------------------------------------------------------------------
-----------------------------------------------------------------------------------------------------
BBBBBBBBBBBBBBBBB-BBBBB------------------------------------------------------------------------------
--------------------------------------------------C--------------------------------------------------
-------------------P----CC---------------------------------------------------------------------------
------B-----------BPP----------------------BB---BBB--------------------------------------BBBB--------
------B----------------------------------------------------------------------------------------------
------B----------------------------------------------------------------------------------B-----------
------B--------------------------------BBBB-----------------------------------------BBBBB-B----------
BBB---B---BBBBBBB-BBBBB------------------------B-B--------XX-------------------------------BB--------
---------------------------------------------------------XXX------------X----------------------------
-------------------------XXXXX---------------------------XXX----------XXX-------X--------------------
--EE----E------------------------------------EEE--E---E--XXX---------XXXX-------X----------------X---
XXXXXXXXXXXXXXXXX-XXXXX--------XXXXXX--XXXXXXXXXXXXXXXXXXXXXXXXXXXXXXXXXXXXXXXXXXXXXXXXXXXXXXXXXXXXXX
