-----------------------------------------------------------------------------------------------------
-----------------------------------------------------------------------------------------------------
-----------------------------------------------------------------------------------------------------
---------------------C-------------------------------------------------------------------------------
--------------------------------------------------CC-------------------------------------------------
E----------BBB--------XXXXX--------------------------------------------BBBBB-------------------------
X-------------------------------------------X--------------------------------------------------------
X---------E------------------------------XX----------------------------------------------------------
XX--------------------------------------XXX---CC--------------------B--------------------------------
--------BPB----------------------------XXXX----------------------------BBBBB--E---------------------X
---------------------------------------XXXX----------------------------------XX--------------------XX
---------------------------------------XXXX--------XXX------------------------------------X----XX-XXX
---E-X--------E------------------------XXXX---------------E--X--------E------------EE---XXXX---XXXXXX
XXXXXXXXXXXXXXXXXXXX-------XX-XXXXXXXXXXXX-------------XXXXXXXXXXXXXXXXXXXXXXXXXXXXXXXXXXXXXXXXXXXXXX
