--------------------------------------------------------------------------------------------------------------------
--------------------------------------------------------------------------------------------------------------------
-----------------------X--------------------------------------------------------------------------------------------
----------------------XXX-------------------------------------------------------------------------------------------
----------------------XXX-------------------------------------------------------------------------------------------
----------------------XXXXXX---BBB------------------------------------------BB-----------------BBB------------------
--------------------------------------------------------------------------------------------------------------------
--------------------------------------------------------------------------------------------------------------------
--------------------------------------------------------------------------------------------------------------------
-------------------------------------X----------------------------------------P---BB--------------------------------
-------------------------------------X---XX-----------------------------------------------------X-------------------
-------------------------------------X---XX------------------------------------------------X----X-------------------
-------------------------------------X---XX----------------------------------------C-C-----XX---XX------------------
XXXXXXXXXXXXXXXX-----------------------XXXXXXXXXXXXXXXXXXXXXXXXXXXXXXXXXXXXXXXXXXXXXXXXXXXXXXXXXXXXXXXXXXXXXXXXXXXXX
