---------------------------------------------------------------------------------------------------------------------
---------------------------------------------------------------------------------------------------------------------
---------------------------------------------------------------------------------------------------------------------
---------------------------------------------------------------------------------------------------------------------
---------------------------------------------------------------------------------------------------------------------
------------------------C---------------------------------------------------C------C---------------------------------
--------------CC---C--CC--C--------C--C--C--------------------------------C--C----C------------CC--------------------
--------------------C----C-----------------C---------------C-CC-CC-C-C-C---C--------CC--------C--C-------------------
----------------C----------------C-----CC---CC-CC--C-----------C----C---CC------------C---CC--BBB--------------------
------CCC-C----------------BBB------------C----B-PC-CCC--C-----BBPC---C---------C------C-CBBBB----C------------------
---------C--CC------------------------------------PBP--------------BB-BPB--------C------C----------------------------
-------BBBBP------E----EE-----BBBB-EE----------------------------------------E-----EE-BBB------EES-------------------
-----------------EXXXXXXXX---E----XXXX---S-----ES----------EE----S--------XXXX----XXXX----E---XXXX-------------------
XXXXXX--------XXXXXXXXXXXXXXXX----XXXXXXXXE---XXXX---EE---XXXXXXXXS----EE-XXXX----XXXX----XXXXXXXX-S-----------------
XXXXXX--------XXXXXXXXXXXXXXXX----XXXXXXXXXXXXXXXXXXXXXXXXXXXXXXXXXXXXXXXXXXXX----XXXX----XXXXXXXXXXXX---------------
