---------------------------------------------------------------------------------------------------------------------
---------------------------------------------------------------------------------------------------------------------
---------------------------------------------------------------------------------------------------------------------
---------------------------------------------------------------------------------------------------------------------
---------------------------------------------------------------------------------------------------------------------
--------------------------------C----C-------------------------------------------C----------------C------------------
----------------------C-C------C--C-----------------C-C----------------C--------C--------C---------------------------
------CC--------------------C-C--C--C--------------C-------------C----C-------CC--C---C-----C------------------------
--------------C-C-C----C-C-C-C-BBB---------C-C-C--B----C-C--------C----------C------C-BBBB-C-------------------------
-------BP--C---------C------PB------------C---C--------------------CCCBB-BC-C------C------C---CC---------------------
-------------P-C-C--C-----------------C----------B----------CCBBBB------------------------BB-P-----------------------
------------------------------S----S-E---------------E-------B----BPBB--------E----------S--------EE-----------------
------S----------------ES----SXXXXXXXX------------XXXXE----------------SS-----XXXX----XXXX--------XXXX---------------
XXXXXXXXXX-EE---------XXXXXXXXXXXXXXXX----E----EE-XXXXXXXX-------S----XXXX---EXXXX-ES-XXXXE----S--XXXXXXXX-----------
XXXXXXXXXXXXXX--------XXXXXXXXXXXXXXXX----XXXXXXXXXXXXXXXX----XXXX----XXXXXXXXXXXXXXXXXXXXXXXXXXXXXXXXXXXX-----------
