--------------------------------------------------------------------------------------------------------------------
--------------------------------------------------------------------------------------------------------------------
---------------------------------------------------------------------------------X----------------------------------
--------------------------------------------------------------------------------XXX---------------------------------
--------------------------------------------------------------------------------XX----------------------------------
-------------------------------------------------------------------------BB---BBXXXXX-------------------------------
--------------------------------------------------------------------------------------------------------------------
--------------------------------------------------------------------------------------------------------------------
--------------------------------------------------------------------------------------------------------------------
------------------------------------------------------------------------------------------SXX--B--------------------
------------------------------------------------------------------------------------------EEX-----------------------
-----------------------------SXX----------------------------------------------------------EEX--X--------------------
-----------------------------EEX----------C---------------------------------------C-C-C-C-EEX-------C---------------
XXXXXXXXXXXXXXXXXXXXX----XXXXXXXXXXX--XXXXXXXXXXXXXXXXXXXXXXXXXXXXXXXXXXXXXXXXXXX-XXXXXXXXXXXXXXXXXXXXXXXXXXXXXXXXXX
