---------------------------------------------------------------------------------------------------------------------
---------------------------------------------------------------------------------------------------------------------
---------------------------------------------------------------------------------------------------------------------
---------------------------------------------------------------------------------------------------------------------
---------------------------------------------------------------------------------------------------------------------
-----------C-C--------C--C------------C--C-------------------------------C----------------C--------C-----------------
------C---C----------------C------CC--------------------------C---------C---C---C--CCC--C----------------------------
-------C----C--------C------C-------C--------C-C---------------C-------------C-C-C----C------C--CCC------------------
---------CP----CC--CC----B-------C---C------C------C------------CCC-C-------------C------BBP---C---------------------
------BPPB----C-----------BBBB------------C---C-CCBBPBC--CCC----------------------------------C----------------------
--------------------------------C----------B--PPPB-----C-----C-------C-----------------------------------------------
-----------EE----------EE------BBP-------E------------B--B-----------B-SE----EE----------SE--------E-----------------
------S---XXXX----S---XXXX---S-----ES-XXXX-----------E-----------S----XXXXXXXXXXXX-EE-XXXXXXXX----XXXX---------------
XXXXXXXXXXXXXX----XXXXXXXXXXXX----XXXXXXXXE---E-S-XXXX--------XXXX----XXXXXXXXXXXXXXXXXXXXXXXX-EEEXXXX---------------
XXXXXXXXXXXXXX----XXXXXXXXXXXX----XXXXXXXXXXXXXXXXXXXX--------XXXX----XXXXXXXXXXXXXXXXXXXXXXXXXXXXXXXX---------------
