--------------------------------------------------------------------------------------------------------------------
--------------------------------------------------------------------------------------------------------------------
--------------------------------------------------------------------------------------------------------------------
--------------------------------------------------------------------------------------------------------------------
--------------------------------------------------------------------------------------------------------------------
------------------BBBPB-----------------------------------------------------BB----------------BBBBBBB---------------
--------------------------------------------------------------------------------------------------------------------
----------------------------------------------------------------------------------------------C---------------------
--------------------------------------------------------------------------------------------------------------------
--------------------P---------------P-------------------------------------BB-----P--P--PB---BBB---------------------
------------------------------ESX-----------------------------------------------------------------------------------
------------------------------EEX-------SXX-------------------------------------------------------------------------
----------------C---C----C----EEXC------EEX--------------------------------------C----------------------------------
XXXXXXXXXXXXXXXXXXXXXXXXXXXXXXXXXXXXXXXXXXXXXXXXXXXXXXXXXXXXXXXXXXXXXXXXXXXXXXXXXXXXXXXXXXXXXXXXXXXXXXXXXXXXXXXXXXXX
