---------------------------------------------------------------------------------------------------------------------
---------------------------------------------------------------------------------------------------------------------
---------------------------------------------------------------------------------------------------------------------
---------------------------------------------------------------------------------------------------------------------
---------------------------------------------------------------------------------------------------------------------
---------------------------------------------C---------C-----------------------------------C----C--------------------
------------------------------CCC-------C--CC--------CC---C--C----------------------------C-C-C----------------------
---------------------C-C---------C--------C---C-C-C-----CC-----C-C--C-------C------CC--------C-C---------------------
------C------C--C---C---CCC--C-----C---------------BBB------------C---------------C----CC-B--------C-----------------
---------C--C--C------C----C--P-B---C----------C-C-----------------C-C-C-C----C--C---CC------------------------------
-------C---------C-------B--C--------C-----------B---------------BBBPPPBPB-B----------------------C------------------
--------BBPB-BBP-B--------PB-B------------E----------ES---------------------------------PBE----EES-------------------
------------------S-----------E----------EXXXX----XXXXXXXXE-E-----------------------------XXXXXXXX-------------------
XXXXXX------------XXXX-SE-----XXXX----XXXXXXXX-EE-XXXXXXXXXXXX---SS----EE----S-----SE-----XXXXXXXX----XXXX-----------
XXXXXX------------XXXXXXXX----XXXX----XXXXXXXXXXXXXXXXXXXXXXXXXXXXXXXXXXXXXXXX----XXXX----XXXXXXXX----XXXX-----------
