---------------------------------------------------------------------------------------------------------------------
---------------------------------------------------------------------------------------------------------------------
---------------------------------------------------------------------------------------------------------------------
---------------------------------------------------------------------------------------------------------------------
---------------------------------------------------------------------------------------------------------------------
-----------------------------------------------C-----------------------------------C-C----------C--------------------
------C--C----C--C-C--C-----------------------C-CC------C----C-------C----------C-------------C--C-------------------
---------------CC-C---------C---C---------------------CC--CC-------C----------CC--------CC---------------------------
-------CC--CC-------CC-CC----C-----C--------C-PBBP---C---C--------C-C--C-C--C----C----C------------------------------
-------BB-BBB------------B-C--------CC---C-C------C---P--------C----BB----C------------P-B---C-----------------------
---------------------------PBB---------------C-----CC---------C-C-------C--C-C---------------------------------------
-------------------------------------------B-P-EE--P-B-----ES---------B-BB-BP------SE-----P----ES--------------------
------E----EE----SE----SE---------------------XXXX----E---XXXX----S-----------E---XXXX---E----XXXX-------------------
XXXXXXXXXXXXXXXXXXXXXXXXXX---ES----SE----E----XXXX----XXXXXXXX----XXXX--------XXXXXXXXXXXX----XXXXSE--XXXX-----------
XXXXXXXXXXXXXXXXXXXXXXXXXXXXXXXXXXXXXXXXXX----XXXX----XXXXXXXX----XXXX--------XXXXXXXXXXXX----XXXXXXXXXXXX-----------
