--------------------------------------------------------------------------------------------------------------------
--------------------------------------------------------------------------------------------------------------------
--------------------------------------------------------------------------------------------------------------------
--------------------------------------------------------------------------------------------------------------------
--------------------------------------------------------------------------------------------------------------------
---------------------------------B--BBB------------------------------------BBBBP--P-----------BBBBB-B---------------
--------------------------------------------------------------------------------------------------------------------
--------------------------------------------------------------------------------------------------------------------
--------------------------------------------------------------------------------------------------------------------
--------------------P--P-----B--------------------------------------------------------------------------------------
--------------------------------------------------------------------------------------------------------------------
---------------SXX---------------------------------------------------------------------SXX--------------------------
---------------EEXC-C--------------------------------------------------------------C---EEX------CC------------------
XXXXXXXXXXXXXXXXXXXXXXXX-XXXXXXXXXXXXXXXXXXXXXXXXXXXXXXXXXXXXXXXXXXXXXXXXXXXXXXXXXXXXXXXXXXXXXXXXXXXXXXXXXXXXXXXXXXX
