-----------------------------------------------------------------------------------------------------
-----------------------------------------------------------------------------------------------------
BBBBBBB--------E---------------------------C-------------------------------------------------P-------
-----------------------------------------------------------------------------------------------------
-----------------------------------------------------------------------------------------------------
--------------------------------------CC--------------------------------B-B-BBB--BBBBB---------------
-C----------------------------E------------------------------------------------------------------XX--
-----------------------------XX--------------------------X------------------------------------------X
B-----------E----------------XX--------XXXXXXXX-----E---------------------------------------B--------
---XXXXX--EXX----------------XX--------------------XX--------CC------BBBBBBBPBB-EPBBBBB--------------
--XXXXXX-XXXX----------------XX----------------------------------------------------------------XXX---
--XXXXXX-XXXX----------------XX---X-------------------------------------------------------B----------
E-XXXXXX-XXXX--XX------------XX--XX---------------------E--X------------------------------b----------
XXXXXXX--XXXXXXXXXXXXXXXXXXXXXXXXXXXX------------XXXXXXXXXXXXXXXXXXXXXXXXXXXXXXXXX--XXXXXXXXXX------X
