--------------------------------------------------------------------------------------------------------------------
--------------------------------------------------------------------------------------------------------------------
--------------------------------------------------------------------------------------------------------------------
--------------------------------------------------------------------------------------------------------------------
--------------------------------------------------------------------------------------------------------------------
-----------------------------------------------------------------------------------------------BBBB-----------------
--------------------------------------------------------------------------------------------------------------------
--------------------------------------------------------------------------------------------------------------------
--------------------------------------------------------------------------------------------------------------------
--------------------------------SXX-PB------------------------------------------------------B-B---------------------
--------------------------------EEX---------------------------------------------------------------------------------
--------------------------------EEX-----------------------------------------------------SX--------------------------
------------------------C-CCC---EEXC----CCC---------------------------------------------EX--------------------------
XXXXXXXXXXXXXXXXXXXXXXXXXXXXXXXXXXXXXXXXXXXXXXXXXXXXXXXXXXXXXXXXXXXXXXXXXXXXXXX---------XX--XX--XXXXXXXXXXXXXXXXXXXX
