-----------------------------------------------------------------------------------------------------
-----------------------------------------------------------------------------------------------------
-------------------------------------------------------------------------BBBBBBBBBBBBBBBBBBBBBBBBBBBB
-------------------------------------------------------------------------------------------------BB--
-------------------------------------------------------------------------------------------------BB--
-------------------------------B---------------------------------------------------------------BB----
-----------------------------------------------------------------------------------------------BB----
-----------------------------------------------------------------------------------------------BB----
-----------------------------------------------E----CC-C-CC--------------------------B---------BB----
BBB----------------E----EBBB---B--------------XX------C-C--C----------------------------E--E---BBBB--
E-----------------XX--------------------------XX-----------------------E---------------XX-XX-----BB--
------------------XX--------------------------XX----------------------XX---------------XX-XX-----BB--
----EE------------XX--E--------------X-E------XX----------------------XX-----E---------XX-XX----E----
XXXXXXXXX-XXXXXXXXXXXXXXXXXXXXXXXXXXXXXXXX-XXXXXXXXXXXXXXXXXXXXXXXXXXXXXXXXXXXXXXXXXXXXXXXXXXXXXXXXXX
