-----------------------------------------------------------------------------------------------------
-----------------------------------------------------------------------------------------------------
BBBBBBBBBBBBBBBBBBBBBBBBBBBBBBBBBBBBBPBBBBBBBBBBBBBBBBBBBBBBBBBB-------------------------------------
-----------------------------------------------------------------------------------------------------
-------------------------------------------E---------------------------------------------------------
CCCCCCCC---C---C---CCCCCCCCCCCCCCCCCCC-----BB------------B----------------XX--E--PBB--E--------------
-------------------------------------------BB------------B-------------------XX------XX--------------
BBBBBBBB-B-B-B-B-B-BBBBBBBBBBBBBBBBBBB-----BB------------B-------------------XX------XX--------------
-B-B---BCBCBCBCBCB-BBBBBBBBBBBBBBBBBBB-----BB------------B-------------------XX------XX--------------
-B-B---BBBBBBBBBBB-------------------------BB-----E--E---B-----XX------------XXB---EBXXBBB---------XX
-----------------------------------------------E-XX-XX--------XXX-----------------XX---------------XX
----------------------------------------------XX-XX-XX-------XXXX-----------------XX---------------XX
E-E-EEE----------------------------------E----XX-XX-XX-------XXXX------------E----XX---------------XX
XXXXXXXXXXXXXXXXXXXXXXXXXXXXXXXXXXXXXXXXXXXXXXXXXXXXXXXXXXXXXXXX----------XXXXXXXXXXXXXXXXXXXXXXXXXXX
