-----------------------------------------------------------------------------------------------------
-----------------------------------------------------------------------------------------------------
----------------B------------------------------------------------------------------------------------
----------------B------------------------------------------------------------------------------------
----------------B------------------------------------------------------------------------------------
----------------B------------------------------------------BBBBBB------------XXX------X-------------X
----------------B-----------------XBBB---------------------------------------XXX-----XX-------------X
----------------B-------E--------XXX-----------X---------------------------XXXXX---XXXX------------XX
-E------------C-B------XX--------XXB-----CC---XX--------------------------XXXXXX--XXXXX-------E---XXX
XX--------------B------XX--------XXX---------XXX--------------BBB-------XXXXXXXX-XXXXXX------XX--XXXX
--------X-------B------XX--------XXX-BB------XXX------------E----------XXXXXXXXX-XXXXXX---------XXXXX
-------XX-E-----B------XX--------XXX---------XXX-----------XX---------XXXXXXXXXX-XXXXXX---------XXXXX
---EE--XX-------B------XX--------XXX---------XXX-----E-----XX--------XXXXXXXXXXX-XXXXXX---------XXXXX
XXXXXXXXX-XXXXXXXXXXXXXXXXXXXX---XXXXX-------XXX-XXXXXXXXXXXXXXXXXXXXXXXXXXXXXXXXXXXXXXXXXXXXXXXXXXXX
