---------------------------------------------------------------------------------------------------------------------
---------------------------------------------------------------------------------------------------------------------
---------------------------------------------------------------------------------------------------------------------
---------------------------------------------------------------------------------------------------------------------
---------------------------------------------------------------------------------------------------------------------
---------------------------------------------C---------------C----C--------------------------------------------------
----------------C-----CC-C----------------CC-----C--------C---C--C-------------C-CC-CC------------C------------------
---------------C----C---C------------CC-----C---C----------C----C---C-----------------C------------------------------
------C-CC-C--C--C---------CC--C---------------C---------C---------PPBC-CCC--C---------C---C----CC-------------------
----------C-C-BBPB-C-C-------C---C--C----------BBB---CC------------------------------B-BB-C----C---------------------
-------C-----C------------C---C-C-B--------------------C---------------C---C-----------------CC----------------------
-----------BP--------------BBBPPBP-------SS-------PB-------EE-----E---B-B-P---E-----------BPP-----SE-----------------
----------------E------SE-------------XXXXXXXXE-E---------XXXX---SXXXX--------XXXX-ES---S---------XXXX---------------
XXXXXX--------XXXXS---XXXX---------EE-XXXXXXXXXXXX--------XXXXXXXXXXXX--------XXXXXXXXXXXX--------XXXXXXXX-----------
XXXXXX--------XXXXXXXXXXXX--------XXXXXXXXXXXXXXXX--------XXXXXXXXXXXX--------XXXXXXXXXXXX--------XXXXXXXX-----------
