---------------------------------------------------------------------------------------------------------------------
---------------------------------------------------------------------------------------------------------------------
---------------------------------------------------------------------------------------------------------------------
---------------------------------------------------------------------------------------------------------------------
---------------------------------------------------------------------------------------------------------------------
-------C-C----------------CC----------------------------------C--C------------C--------------------------------------
--------C------C-C-----C-C------C------C-C------------------------C-CCC--C-----C------------------C------------------
--------------C---------C------C-C----------C-------------------C--C---C----------------------C----------------------
--------BB------------------B-C-------C---CC--C--C-C-C-------C----------C---------------C---C--C-C-C-----------------
--------------BB--------------B--B-CC-------BB-C-------C----------P-BBP--BC--C------C--B-----------------------------
------------CC----------------------------------C-C-C-C--C-C--------------B-------C----------C-----------------------
------E---BBPP---------EE----E----------------BPPPP--P-----------S------------E-----------B--------------------------
XXXXXXXXXX-------S----XXXXXXXXE----------EE-------------------XXXXS----EE-----XXXX-------E--------SE--XXXX-----------
XXXXXXXXXX----XXXX----XXXXXXXXXXXX-EE-XXXXXXXX----------------XXXXXXXXXXXX---SXXXX----XXXX-----ESSXXXXXXXX-----------
XXXXXXXXXX----XXXX----XXXXXXXXXXXXXXXXXXXXXXXX----------------XXXXXXXXXXXXXXXXXXXX----XXXX----XXXXXXXXXXXX-----------
