---------------------------------------------------------------------------------------------------------------------
---------------------------------------------------------------------------------------------------------------------
---------------------------------------------------------------------------------------------------------------------
---------------------------------------------------------------------------------------------------------------------
---------------------------------------------------------------------------------------------------------------------
-------C-CC----------C------C----C--C---------------C----------------------------------------------------------------
------C----------------------------C-C------------C--C-C----------CC-C----------------CC---------C-------------------
--------C---------C--------C-CC-------CC--C----C-C-------C------------------------------C---CC-CC--------------------
----------BP--C-C-------CCB-BB-PBB------C-------C-P-----C----CCC----C--C-CC---C---CCCC-PB-----BP---------------------
---------------C----------------------------CCBB------------C---CCBB-B-----C---------B-----C------CC-----------------
-------------------------------------------BBP------------------BB------------------------B-BP-----------------------
------S----EE-----S----------EE----EE----------------S-----------------PB----------------E-----SSS-------------------
XXXXXXXXXXXXXX----XXXX----XXXXXXXXXXXX---E-----ES-XXXXE-----------E----------------SE-XXXX----XXXX-------------------
XXXXXXXXXXXXXX---EXXXX----XXXXXXXXXXXXXXXXS---XXXXXXXXXXXX-SE----EXXXX-------EE---XXXXXXXXE---XXXXES-----------------
XXXXXXXXXXXXXXXXXXXXXX----XXXXXXXXXXXXXXXXXXXXXXXXXXXXXXXXXXXXXXXXXXXX----XXXXXXXXXXXXXXXXXXXXXXXXXXXXXXXX-----------
