---------------------------------------------------------------------------------------------------------------------
---------------------------------------------------------------------------------------------------------------------
---------------------------------------------------------------------------------------------------------------------
---------------------------------------------------------------------------------------------------------------------
---------------------------------------------------------------------------------------------------------------------
-------------------------------------------C-C------------------CC------------------C-------------CC-----------------
---------------------------C----C-----C-----------------------CC-----C-C-C--------C--C-----C-C-----------------------
------C-----------C---------C-CC--------C-C-C--------C------C-----C-----C---C------C---CCC---------------------------
--------CC-----------C----C--CBB--C------------C----C--C--CC----BB-CC-BBBB-C---------B----C---C----------------------
-------C----C-C-CC----CC-CPBBB-----CCC-----------CC---C-C---------BBBP----------------C--------CC--------------------
-------BB--C-C------------------------------------BP-B---C-----------------------------PB--------C-------------------
----------BB-------------B----S----------EE----BBB-----B---------E-----SS----------EE-------------E------------------
-----------------------------SXXXX----XXXXXXXX----------------XXXXE---XXXX---ES---XXXX----S-------XXXX---------------
------E-----------E-------XXXXXXXX-SE-XXXXXXXX-------S-----SE-XXXXXXXXXXXXXXXXXXXXXXXX--E-XXXX----XXXX---------------
XXXXXXXXXX--------XXXX----XXXXXXXXXXXXXXXXXXXX----XXXX----XXXXXXXXXXXXXXXXXXXXXXXXXXXXXXXXXXXX----XXXXXXXX-----------
