---------------------------------------------------------------------------------------------------------------------
---------------------------------------------------------------------------------------------------------------------
---------------------------------------------------------------------------------------------------------------------
---------------------------------------------------------------------------------------------------------------------
---------------------------------------------------------------------------------------------------------------------
-------CC---------------------------------------------CC----------------CC-------------------------------------------
------C--------CC----------CC----------------C----------C-------------CC--CC----CC-----------------------------------
----------C-CC---C-C-C-------C-------------C----C-----------CCCCCC----------C--C--------C--CC--CC--------------------
----------------------C---C------CC--------------C--C---P-------------B-PB---C---------BB-C--CC--C-C-----------------
--------------------C-------BB--C---CC---C----C---CC-C----C-------CC------B--------C-C----PBBB----C------------------
----------B-BB---------C-------------------------B---------------P----------------C-----------B----------------------
------S-----------------------BBBB----------------P--BS-----------BBBB-SE-----E----------E---------------------------
XXXXXXXXXX-------E-----------E------------E-----------XXXX------------XXXX---SXXXX----XXXXE--------------------------
XXXXXXXXXX-SS-XXXXS-------XXXX-----------SXXXX-SS-----XXXX-SE----E----XXXXXXXXXXXX----XXXXXXXX-ESES------------------
XXXXXXXXXXXXXXXXXXXXXX----XXXX--------XXXXXXXXXXXX----XXXXXXXXXXXX----XXXXXXXXXXXX----XXXXXXXXXXXXXXXXXXXX-----------
