--------------------------------------------------------------------------------------------------------------------
--------------------------------------------------------------------------------------------------------------------
-----------------------X--------------------------------------------------------------------------------------------
----------------------XXX---------------------------------------------------------X---------------------------------
----------------------XXX-------------------------------------------------------------------------------------------
------------------BB-P-XXX---------------BP-------------------------------------------------------------------------
--------------------------------------------------------------------------------------------------------------------
--------------------------------------------------------------------------------------------------------------------
--------------------------------------------------------------------------------------------------------------------
----------------PB-----------B--SXXBBB----B-----------------------------------------P--P-----BB---------------------
--------------------------------EEX---------------------------------------------------------------------------------
--------------------------------EEX---------------------------------------------------------------------------------
--------------------------C-C---EEX------C---------------------------------------------------------C----------------
XXXXXXXXXXXXXXXXXXXXXXXXXXXXXXXXXXXXXXXXXXXXXXXXXXXXXXXXXXXXXXXXXXXXXXXXXXXXXX------XXXXXXXXXXXXXXXXXXXXXXXXXXXXXXXX
