---------------------------------------------------------------------------------------------------------------------
---------------------------------------------------------------------------------------------------------------------
---------------------------------------------------------------------------------------------------------------------
---------------------------------------------------------------------------------------------------------------------
---------------------------------------------------------------------------------------------------------------------
---------------------------------------------------------------------------------------------C-----------------------
------C-------CCC----------------------------------------------------C------CC--------------C------------------------
------------C----C---C-------C-----------C--C---C---CC------C------C----CC-C--C--C--C-C--------C---------------------
-------CCC--------C-------------C----C----C---C--------C--C--C-CCC--C-B--------C--------C-PP----C--------------------
------BBPP-C--------C------C-----C----CC-----C----C---C--C----C---PBBP------------C--C------------C------------------
-----------B-----------C---BP-BBBBCCC-------B-BBBBBBBBB------------------------------BBPBB---------------------------
----------------------------------PB-----------------------------------EE----E------------E--------------------------
------E----------E------------------------------------------------S---XXXXXXXXE-----------XXXX-SES-------------------
XXXXXXXXXX-EE-XXXXE----------EE----------EE---E-E----SE----ES-----XXXXXXXXXXXXXXXX-SE----EXXXXXXXX----XXXX-----------
XXXXXXXXXXXXXXXXXXXXXX----XXXXXXXX----XXXXXXXXXXXXXXXXXXXXXXXX----XXXXXXXXXXXXXXXXXXXXXXXXXXXXXXXX----XXXX-----------
