---------------------------------------------------------------------------------------------------------------------
---------------------------------------------------------------------------------------------------------------------
---------------------------------------------------------------------------------------------------------------------
---------------------------------------------------------------------------------------------------------------------
---------------------------------------------------------------------------------------------------------------------
----------C-C-----------------C---------------C--C----CC----C--C-C---------------------------------------------------
-----------C-------------C-------C---------CCC-----------CC---C------------------C-----------------------------------
------------------------C-------C------------------CC------C-C--C-----C--CC---------------CC-------------------------
----------B-B------C-----B----PPP-------C-C---BB-----C------------C----CC--C-C--P-CCC---C----C-----------------------
-------CC------C-----C-------------CC----C--BB----C----------------CC-BB---------------C----C---C-CC-----------------
------C---------CC---------C------C--CC-----------B--------------------------------PBPC---BBB-CC---------------------
------BBB--ES----------EE-PBPPE----------------EE-----S----ES----S------------E-------PB-B---------------------------
XXXXXX----XXXX--------XXXX----XXXX--------E---XXXX----XXXXXXXXXXXX-----EE-----XXXX-----------------------------------
XXXXXX----XXXX----E---XXXX----XXXX--------XXXXXXXX---EXXXXXXXXXXXXE---XXXX---SXXXXE-E-----S-------S------------------
XXXXXX----XXXX----XXXXXXXX----XXXX--------XXXXXXXXXXXXXXXXXXXXXXXXXXXXXXXXXXXXXXXXXXXX----XXXX----XXXXXXXX-----------
