---------------------------------------------------------------------------------------------------------------------
---------------------------------------------------------------------------------------------------------------------
---------------------------------------------------------------------------------------------------------------------
---------------------------------------------------------------------------------------------------------------------
---------------------------------------------------------------------------------------------------------------------
--------------------------------C------------------------------------------------------C--CC-C-----------------------
----------C-C------------------C-CC--CCC-C-----C----------C--C---------------------------C-----C-CC------------------
-----------C---C--C-----CC-C--------C-------CC-----CC----------------C--------CC--------------C----------------------
------C---BPPB----------------BPB----------C-----C---C-----CC--CCCC--------------C---C--PBP--------------------------
-------CC-------------------------------------PBBBBBBB--C-----C-------C-CCCC-C---------------------------------------
--------BP----P---------B-P----------------------------C-C--------B-B-------C-----C-C--------------------------------
-----------ES-----S-----------E----EE---------------------------------BB-PPBB------------SE----S---------------------
----------XXXX----XXXX--------XXXXXXXX---EE----ES----E-----SE-----------------E-------XXXXXXXXXXXX-E--XXXX-----------
------E---XXXX---EXXXX-EE----EXXXXXXXXXXXXXXXXXXXXXXXX----XXXX---EE-----------XXXX----XXXXXXXXXXXXXXXXXXXX-----------
XXXXXXXXXXXXXXXXXXXXXXXXXXXXXXXXXXXXXXXXXXXXXXXXXXXXXX----XXXXXXXXXXXX--------XXXX----XXXXXXXXXXXXXXXXXXXX-----------
