--------------------------------------------------------------------------------------------------------------------
--------------------------------------------------------------------------------------------------------------------
--------------------------------------------------------------------------------------------------------------------
--------------------------------------------------------------------------------------------------------------------
--------------------------------------------------------------------------------------------------------------------
--------------------------------------------------------------------------------------------------------------------
--------------------------------------------------------------------------------------------------------------------
--------------------------------------------------------------------------------------------------------------------
--------------------------------------------------------------------------------------------------------------------
-----------------------------------XXX--XXX---------------------------------------------------XX---XX---------------
-----------------------------------XXX--XXX-----------------------------------------------XX--XX---XX---------------
-------------------------------XXXXXXX--XXX-----------------------------------------------XXXXXX---XX---------------
-------------------------------XXXXXXX--XXX----------------------------------------------XXXXXXX--XXX---------------
XXXXXXXXXXXXXXXXXXX------------XXXXXXXXXXXXXXXXXXXXXXXXXXXXXXXXXXXXXXXXXXXXX---XXX---XXXXXXXXXXXXXXXXXXXXXXXXXXXXXXX
