-----------------------------------------------------------------------------------------------------
-----------------------------------------XXXXXXX-----------------------------------------------------
-----------------------------------------------------------------------------------------------------
-------------E-----------------XX-------------------E------------------------------------------------
----------XXXXXXX--------------XX------------------XXXXXXXX------------------------------------------
-------------------------------XX--------------------------------------------------------------------
------E-X----------------------XX-------------------------------------------C------------------------
---------------------E---------XX--------------------------------------------------------------------
--------------------XX----E----XX-----------------X-----------BBBBBBBBBBBBB------CCCCC-C-------------
--------------------XX--EXX----XX-----------------------------------------------C----------X--B------
BBB-----------------XX-XXXX----XX-----EXX-------------------------------------------------XX---------
--------------------XX-XXXX----XX-----XXXXXXXXXX------------------------------------------XXX--------
--------------------XX-XXXX----XX----XXXX-----------------------E-------E-----------------XXX-----E--
-----------------XXXXXXXXXXXXXXXXXXXXXXX----------------------XXXXXXXXXXXXXXXXXXXX-------XXXX-XXXXXXX
