-----------------------------------------------------------------------------------------------------
-----------------------------------------------------------------------------------------------------
-------------------------------------------------------------------------------CCC-------------------
-------------------------------------------------------------------------------XXXX------------------
------------CC------------------------CC------E-----------------------------------------CCCCCCC------
------------------CC--------------------------E------------XXX--------------------------XXXXXXX------
-------------------------------XBBB------------------------XXX------X--------------------------------
-----------------------------XXXX-------------------E------XXX---------------------------------------
BB-----------------XXX------XXXXB------------------XX------XXX--E------------------------------------
X--XXXXXXXXX-XXXXX---------XXXXXX------------------XX----E-XXX-XX-------XXXXX-------------------XX---
X------------------------EXXXXXXX-BB---------------XX---XX-XXX-XX--------------XXXXXXXXP-------------
X---------------------XX-XXXXXXXX------XXXXXX------XX---XX-----XX------------------------------------
X---------------------XXXXXXXXXXX------------------XX---XX-----XX------------------------------------
---------------------XXXXXXXXXXXXXX-------------X-XXXXXXXXXXXXXXX-----XXX--------------XXXXXXXX------
