-----------------------------------------------------------------------------------------------------
-----------------------------------------------------------------------------------------------------
BBBBBBBBBBBBBBBBBBBBBBBBBBBBBBBBB--------------------------------------------------------------------
BBBBBBBBBBBBBBBBBBBBBB----BBBB-----------------------------------------------------------------------
BBBBBBBBBBBBBBBBBBBBBB----BBBB-----------------------------------------------------------------------
BBBBBBBBBBBBBBBBBBBBBB--------------------------------------------------------------BBBBBBBBBB-------
------------------------------------CCC--------------------------------------------------------------
----------------------------------------------------X------------------------------------------------
CCCCCCCCCCCCCCCCCC---------E-----------------------XX-----------------------------------------------X
BBBBBBBBBBBBBBBBBB----XX--BBBB----B---------------XXX--XX------E-------------------X--E------------XX
---------------------XXX-EE-----B----------------XXXX--XX--E--XX------------------XX--------------XXX
--------------------XXXX--------B---------------XXXXX--XX-XX--XX-----------------XXX--------------XXX
EEE-----E---EE-----XXXXX--------B--------------XXXXXX--XX-XX--XX------E---------XXXX--------E-----XXX
XXXXXXXXXXXXXXXXXXXXXXXXXXXXXX--XXXXXXXXXXXXXXXXXXXXXXXXXXXXXXXXXXXXXXXXXXXXXXXXXXXXXXXXXXXXXXXXXXXXX
