-----------------------------------------------------------------------------------------------------
-----------------------------------------------------------------------------------------------------
BBBBBBBBBBBBBBBBB------------------------------------------------------------------------------------
BBBBBBBBBBBBBBB--------------------------------------------------------------------C-----------------
BBBBBBBBBBBBBBB---------------------ECCC------------------------------------------XXX----------------
BBBBBBBBBBBBBBB---------------CC----XXXXXXXX-------BB------------------------------------------------
------------------------------X---------------------------CCC----------------------------------------
-----------------------------------------------------------------------------------------------------
PCCCCCCCCCC---------------------------------XX-------------------------E-------BB--------------------
PPBBBBBBBBB----XXX--------------XXXXXXXXX----------BBBB---------------XX-------------------B-B-------
--------------XXXX-------X---------------------E----------------------XX---E------------------------E
-------------XXXXX------XX--------------------XX----------------------XX---------------------------XX
---------E--XXXXXX--EE-XXX-E------------------XX--E-----E-------------XX-----------------EE--E-----XX
XXXXXXXXXXXXXXXXX--XXXXXXXXXXX---------------XXXXXXXXXXXXXXXXXXXXXXXXXXXXXX-XXXXXXXXXXXXXXXXXXXXXXXXX
