-----------------------------------------------------------------------------------------------------
-----------------------------------------------------------------------------------------------------
BBBBBBBBBBBBBBBBBBBBBBBBBBBBBBBBBBBBBBBBB------------------------------------------------------------
-----BBBBBB--------------BBBBB-----------------------------------------------------------------------
-----BBBBBB--------------BBBBB-----------------------------------------------------------------------
-------------------------BBBBB-----------------------------------------------------------------------
-----------------------------------------------------------------------------------------------------
-----------------------------------------------------------------------------------------------------
E-----E----------------E------------------------------E------------------------------------------P---
X----BBBBBB---------E-XX------XX-BBBBBBBB------------XX---XX-----------------------------------------
X---EE-------------XX-XX-----XXX---------------------XX---XX----------E------------------------------
X------------------XX-XX----XXXX---------------------XX---XX---------XX------------------------------
X------------------XX-XX---XXXXX---------------E-E---XX---XX---E-----XX----E----------E------EE------
X-XXXXXXXXX-XXXXXXXXXXXX--XXXXXXXXXXXXXXX-XXXXXXXXXXXXXXXXXXXXXXXXXXXXXXXXXXXXXXXXXXXXXXXXXXXXXXXXXXX
