--------------------------------------------------------------------------------------------------------------------
--------------------------------------------------------------------------------------------------------------------
--------------------------------------------------------------------------------------------------------------------
--------------------------------------------------------------------------------------------------------------------
--------------------------------------------------------------------------------------------------------------------
-------------------------------------------------------------------------BB---BBBB----------------------------------
--------------------------------------------------------------------------------------------------------------------
--------------------------------------------------------------------------------------------------------------------
--------------------------------------------------------------------------------------------------------------------
------------------------------------XX---XX-------------------------------------------------XXXX---XX---------------
--------------------------------XX--XX---XX------------------------------------------------XXXXX---XX---------------
--------------------------------XXXXXX---XX----------------------------------------------XXXXXXX--XXX---------------
-------------------------------XXXXXXX--XXX----------------------------------------------XXXXX-X--XXX---------------
XXXXXXXXXXXXXXX-----------------XXXXXX-XXXXXXXXXXXXXXXXXXXXXXXXXXXXXXXXXXX-XXXX----------XXXXXXXXXXXXXXXXXXXXXXXXXXX
