---------------------------------------------------------------------------------------------------------------------
---------------------------------------------------------------------------------------------------------------------
---------------------------------------------------------------------------------------------------------------------
---------------------------------------------------------------------------------------------------------------------
---------------------------------------------------------------------------------------------------------------------
------------C--------------------------C--------C---------------C----------------------------------------------------
---------C-----------------C---CCC-CCCC-------CC-C--C-CC-C-------C----------------------------C--C-C-----------------
------C--------------C---C----C-----------C-------------C------C-------C------------CC-------------------------------
--------C--PBB---CC---C-C-C-CC----C-----------B--B---------C-C-----------CC--------C---CCC--C------------------------
------BBBB----CC-----B----BB----------------------BB--------C-------CC--C----CC-C-BB--C------C-----------------------
----------------C------BBB-------------------B------------C--------C---BB-----------------C--------------------------
-----------EE-----------------S----------E-----EE----------------EBPBB-----------------BB------E---S-----------------
------E---XXXX----S----------SXXXX-EE-XXXX----XXXX---SS-------XXXX----------------E-E---------XXXXXXXX---------------
XXXXXXXXXXXXXX----XXXXE-S-XXXXXXXXXXXXXXXXE---XXXXXXXXXXXX----XXXX-----ES---------XXXX--------XXXXXXXX---------------
XXXXXXXXXXXXXX----XXXXXXXXXXXXXXXXXXXXXXXXXXXXXXXXXXXXXXXX----XXXX----XXXX--------XXXX--------XXXXXXXX---------------
