-----------------------------------------------------------------------------------------------------
-----------------------------------------------------------------------------------------------------
BBBBBBBBBBBB-----------------------------------------------------------------------------------------
BBBBB------------------------------------------------------------------------------------------------
BBBBB---------------------------ECCCCCC--------------------------------------------------------------
--------------------------------XXXXXXXX--------------------------------------------------BB---------
-----------------------------------------------------------------------------------------------------
---------------XBB--C---------------------------------------------------------------------------B----
E-------------XXX-----------------------------C------CC---------------------------------BB------b----
BBBBB--------EXXX-BB-----------XXXXXXXXXXXXX------------C-------BBBBBBB---B---BB----XX-----BBBBBXBB--
------BB---XXXXXX-----------------------------------------------------------E-------XX---------------
------BB---XXXXXX--BBB--XX----------------------------------------------------------XX---------------
------BB---XXXXXX-------XX---------------------------------E------------------------XX-----EE--------
XXXXX-XX---XXXXX------XXXXXXXX--------------XXXXX---XXXXXXXXXXXXXXXXXXXXXXXX-XXXXXXXXXXXXXXXXXXXXXXXX
