---------------------------------------------------------------------------------------------------------------------
---------------------------------------------------------------------------------------------------------------------
---------------------------------------------------------------------------------------------------------------------
---------------------------------------------------------------------------------------------------------------------
---------------------------------------------------------------------------------------------------------------------
----------------------------------------------------------------------------CC---------------------------------------
------C----------C------C---------CC--------------------------------------C-----C-----CC----C------------------------
---------------C------C--CC-CC--C---C---------CC-C--C-----------CC------------CC--C-----------C-C--------------------
-----------C-------------B-C---C-----C---C--------C--C-C-------C--C--------------C------CC-----C-C-------------------
--------------B---------------C--CBP---C--CCCC--C-P-BB------C---BP------C------------C---PBB-B----CC-----------------
----------C---------------BPPBB-BB------C------B-B-------C-C-C----PP-B---C---------------------P---------------------
------------B----------EE-----------------------------P----------------B-----S---------------------------------------
------E----------SS---XXXX--------E-S----------------E-----------S--------XXXXS----------SS--------------------------
XXXXXXXXXX----XXXXXXXXXXXX---SS---XXXX----S----SE-XXXX--------XXXXE-------XXXXXXXX-SE-XXXXXXXX-E-E-------------------
XXXXXXXXXX----XXXXXXXXXXXXXXXXXXXXXXXX----XXXXXXXXXXXX--------XXXXXXXX----XXXXXXXXXXXXXXXXXXXXXXXX-------------------
