-----------------------------------------------------------------------------------------------------
-----------------------------------------------------------------------------------------------------
-----------------------------------------------------------------------------------------------------
-----------------------------------------------------------------------------------------------------
-----------------------------------------------------------------------------------------------------
----------------BBBBB----------------P-----------------------------XX---X---------BBB----------------
-----------------------------------------------------------------------------------------------------
-----------------------------------------------------------------------------------------------------
-----------------------------------------------------------------------------------------------------
E--------------X--B------------------B---E--------------------------XXXXXXXXX-------EBB---------BB---
X--------------X-----------E------------XX-----------------------------------------XX----------------
---------------XX---------XX------------XX------------------B----------------------XX---------B------
------------E--XX--E------XX------------XX------------------b----------------------XX---------b------
XXXXXXX-XXXXXXXXXXXXXXXXXXXXXXXXXXXXXXXXXXXXXXXXXXXXX-XX---XXXXXXX------------XXXXXXXXXXXXXXXXXXXXXXX
