-----------------------------------------------------------------------------------------------------
-----------------------------------------------------------------------------------------------------
-----------------------------------------------------------E-----------------------------------------
-----------------------------------------------------------------------------------------------------
----------------------------------------------------------------------------------------------E------
---------------------------B-------------------------------------------------------XXXXX-----BBBBBB--
----------------------------------------------------------------------------------XXXXXX-------------
--XBB--C-------------------------------------------------------------------------XXXXXXX-------------
-XXX-------------------------XXXXX--------E--------------------------E-----------XXXXXXX-------------
EXXX-BB------------E--C----B-------------XX-------------------------XX----------XXXXXXXX-----BBBBB---
XXXX--------------XX-----------------E---XX-------------------------XX--E------XXXXXXXXX-------------
XXXX--BBB---------XX----------------XX---XX-------------------------XX-XX-----XXXXXXXXXX-------------
XXXX--------------XX---------CCC----XX---XX------E---------XX---EEE-XX-XX--E-XXXXXXXXXXX-------------
XXX------XXXXXXXXXXXXXXXXXXXXXXX--XXXXXX-XXXXXXXXXXXXXXXXXXXXXXXXXXXXXXXXXXXXXXXXXXXXXXXXXXXXXXXXXXXX
