---------------------------------------------------------------------------------------------------------------------
---------------------------------------------------------------------------------------------------------------------
---------------------------------------------------------------------------------------------------------------------
---------------------------------------------------------------------------------------------------------------------
---------------------------------------------------------------------------------------------------------------------
------------------------------------------------------------CC--------C----------------------------------------------
------------------------C--------------------------C-------C------C--C--C---------------------C--C-------------------
-------C---C--C-------CC-CCC------C-----------------CC-C------------C--C----C-C----C--------------C------------------
---------------C---C-----B--BP---C--C----CC--C----B---C-CC----C-------BB-B-C----------C---CC----C--------------------
-------------C-BB---C----------CC--C-C-C---C--C------------------CPBBP----C-----CC--C---C----C-----------------------
------------PP--------------------P-----C--BBB-C----------------C----------------------C-C--C------------------------
-----------------------EE----EPBB-------------BPB----E-----ES-P--B-----ES---------------PB---------E-----------------
-----------------S----XXXXXXXX--------------------XXXXE---XXXX----E---XXXX---------------------S-EXXXXXXXX-----------
------S----EE-XXXXE---XXXXXXXX----E-E-----E-------XXXXXXXXXXXX----XXXXXXXX---SE----EE---------XXXXXXXXXXXX-----------
XXXXXXXXXXXXXXXXXXXXXXXXXXXXXX----XXXX----XXXX----XXXXXXXXXXXX----XXXXXXXXXXXXXXXXXXXX--------XXXXXXXXXXXX-----------
