---------------------------------------------------------------------------------------------------------------------
---------------------------------------------------------------------------------------------------------------------
---------------------------------------------------------------------------------------------------------------------
---------------------------------------------------------------------------------------------------------------------
---------------------------------------------------------------------------------------------------------------------
---------------------------------------------------------------------------------------------------------------------
----------CC-----------C------------CC---C-C----------------C---------------------CC--C------C--C--------------------
------------CCCCC--C----C-----C-----------C--CCC-C----CC-------CC--------------------C-----------CC------------------
------CC------------C-----------CC-C--CC----C------C-------------C--CCC--CC-CCC-CC--------C----C---------------------
----------BB-B---------B-B-C-C-C---B------------C---CC--CC--------CC--BBB--------------B--BBP------------------------
--------------------------C-C-B-BP-------------BB-C---PB-----------------------C-------------------------------------
-----------------E--------P-BB--------------------PPPB-------------PBB----B--------SS-------------EE-----------------
------E----EE-XXXXE----EE----------EE----EE----------------ES----S-----EE---------XXXX---SE----EE-XXXX---------------
XXXXXXXXXXXXXXXXXXXXXXXXXX----S---XXXXXXXXXXXX-EE-----S---XXXXXXXX----XXXX--------XXXXXXXXXXXXXXXXXXXX---------------
XXXXXXXXXXXXXXXXXXXXXXXXXX----XXXXXXXXXXXXXXXXXXXX----XXXXXXXXXXXX----XXXX--------XXXXXXXXXXXXXXXXXXXX---------------
