-----------------------------------------------------------------------------------------------------
-----------------------------------------------------------------------------------------------------
-----------------------------------------------------------------------------------------------------
-------------------------------------------------------------------------------------------C-C-C-C-C-
----------------------------------CCCCCCCC------------------------------------------------XXXXXXXXXXX
----------------------------------------------------XX-----------------------------------------------
------------CCC-------------------------------------XX-----------------------------------------------
--------------------------------------XX------------XX-----------------------------------------------
-------------------E---------CC---------------------XX--------------------------CCCC-----------------
------------------XX--------------------------------XX-----------------------------------------------
------------------XX--------------------------------XX-----------E-----------------------------------
------------------XX---------------------XX---------XX----------XX----B------------------------------
-----X------------XX----XXX-------------------------XX----------XX----b------------------------------
XXXXXXXXXXXXXXXXXXXXXXXXXXXX------XXXXX-----XXXXXXX-XXXXXXXX--XXXXXXXXXXXXXXXXX--XX--XXXXXXXXXXXXXXXX
