--------------------------------------------------------------------------------------------------------------------
--------------------------------------------------------------------------------------------------------------------
--------------------------------------------------------------------------------------------------------------------
----------------------------------------------------------------------------------X---------------------------------
--------------------------------------------------------------------------------------------------------------------
------------------BB-P----------------------------------------------------------------------------------------------
--------------------------------------------------------------------------------------------------------------------
--------------------------------------------------------------------------------------------------------------------
--------------------------------------------------------------------------------------------------------------------
-------------------BBB-P---------------XX-------------------------------------------------SXX-----------------------
-------------------------------SX-----XXX-------------------------------------------------EEX-----------------------
-------------------------------SXX---XXXX-------------------------------------------------EEX-----------------------
----------------C-C-C----------EEX-XXXXXX---------------------------------------------C-C-EEXC------C---------------
XXXXXXXXXXXXXXXXXXXXXXXXXXXXXXXXXXXXXXXXXXXXXXXXXXXXXXXXXXXXXXXXXXXXXXXXXXXX---XXX---XXXXXXXXXXXXXXXXXXXXXXXXXXXXXXX
