---------------------------------------------------------------------------------------------------------------------
---------------------------------------------------------------------------------------------------------------------
---------------------------------------------------------------------------------------------------------------------
---------------------------------------------------------------------------------------------------------------------
---------------------------------------------------------------------------------------------------------------------
---------------------------------------------------------------------------CCC---------------C-----------------------
------------------C----C-------------CCCCC-------------------C-------------------------------------------------------
------------C----C-C-CC-C---C---C--C---------------CC--C-C----C----------------C----------C--------------------------
------C-CC----CC---------CCC--C---C-C----------C----------C------CCC----------C---------C-BBB-C---C------------------
-------C---C------------------BPB---------C-------BP-B----------C----C--CC-----------CCC-------CC--------------------
----------BBBPB-----------PPBB-------------CCC------------------------C-----------CCC----C---------------------------
-------BBB--------E---------------------E-----BBP-----------------P-BBBPBB---S---------BBBE--------------------------
------------------XXXX-SE-----S----SS-XXXX-----------EE----EE-------------XXXX------------XXXX-----------------------
-----------EE----SXXXXXXXX---EXXXXXXXXXXXX--------XXXXXXXXXXXX---S--------XXXXE-----------XXXX-----E--XXXX-----------
XXXXXX----XXXXXXXXXXXXXXXXXXXXXXXXXXXXXXXX--------XXXXXXXXXXXXXXXX--------XXXXXXXX--------XXXX----XXXXXXXX-----------
