--------------------------------------------------------------------------------------------------------------------
--------------------------------------------------------------------------------------------------------------------
--------------------------------------------------------------------------------------------------------------------
--------------------------------------------------------------------------------------------------------------------
--------------------------------------------------------------------------------------------------------------------
-------------------------------BBBB--BBBP---------------------------------------------------------------------------
--------------------------------------------------------------------------------------------------------------------
------------------------------C-------------------------------------------------------------------------------------
--------------------------------------------------------------------------------------------------------------------
--------------------------P-BPB---------------------------------------------------BB-P---------XX-------------------
----------------------------------------------------------------------------------------------XX----X---------------
-------------------------------------------------------------------------------------------XXXXX---XX---------------
------------------------------------------C----------------------------------------C-------XXXXX---XX---------------
XXXXXXXXXXXXXXXXXXXXXX--XXXXXXXXXXXXX--XXXXXXXXXXXXXXXXXXXXXXXXXXXXXXXXXXXXXXX-XXXXXXXXXXXXXXXXX-XXXXXXXXXXXXXXXXXXX
