-----------------------------------------------------------------------------------------------------
-----------------------------------------------------------------------------------------------------
--E--------------------------------------------------------------------------------------------------
-----------------------------------------------------------B-----------------------------------------
---------------------------------------------------------------X-------------------------------------
----------------------------------------------BBB--BB----------------------------------BBBBBB--------
------------------------------------------CC--------------X--E---------------------------------------
-----------------------------------------------------------------------------------------------------
P--------------------------------------------------------------------------------------------------E-
--------------E-B-------------------------------BBPBB---------------------------------X-----------XX-
-------------XX---------------E------------------------------------E-------------X-X-XX-----------XX-
-------------XX--------------XX-------------------------------------------------XXXXXXX-----------XX-
--XX---------XX-----EE-------XX-------------------E--------------------E-------XXXXXXXX-----------XX-
XXXXXXXXXXXXXXXXXXXXXXXXXXXXXXXXX--XXXXXX-XXXXXXXXXXXXXXX--------XXXXXXXXXXXXXXXXXXXXXXX-----XXXXXXXX
