---------------------------------------------------------------------------------------------------------------------
---------------------------------------------------------------------------------------------------------------------
---------------------------------------------------------------------------------------------------------------------
---------------------------------------------------------------------------------------------------------------------
---------------------------------------------------------------------------------------------------------------------
-----------------------CCC---------------C---------------------------------------C-----------------------------------
----------------------C----C----------C-C--CC-----C-C-----C--C-------------------------------------------------------
--------------C-C--CC-----C--C---C-----------------C---C-C------C--------------C----C-C--C---------------------------
------CC--C--C--------------BPC-----------C---CC-----CC-C---C-C--------C--CCC-----C----CC----------C-----------------
-----------CC----C------------PPBB---C----PBPB--C-------------BB-P-CCC---------------C---------C---------------------
--------BPB-BP--------------------CCC------------C-----------------PPB--CC------------BB-B-BBB--CC-------------------
-----------------------SE----E----B------S----BBB-----------------------------S---------------BBP--------------------
------------------E---XXXXXXXXE-------XXXXS----------S-----EE----S------------XXXX-----------------------------------
------E----SS----SXXXXXXXXXXXXXXXX----XXXXXXXX----XXXXE---XXXXXXXXE----------SXXXX-SE----EE-------SE-----------------
XXXXXXXXXXXXXXXXXXXXXXXXXXXXXXXXXX----XXXXXXXX----XXXXXXXXXXXXXXXXXXXX----XXXXXXXXXXXXXXXXXXXX----XXXXXXXX-----------
