-----------------------------------------------------------------------------------------------------
-----------------------------------------------------------------------------------------------------
-----------------------------------------------------------------------------------------------------
-----------------------------------------------------------------------------------------------------
E-------------------------------------------------------------------XX-------------------------------
BBBBBPBBBBBBBB----------CCC--------------------X-----------------------------BBBB---BBB--------------
------------------------X----------------------X-----------------------------------------------------
----------------------------------------------XX------------------X----------------------------------
--------E---E-------------XX--X----------C---XXX-----------------XX-----E-----------------------CC---
BBBBBBBBBBPBBB---------------XX----B--------XXXX------------X---XXX----XX---BPBBB--B--BB-----CCC-----
---------------------E-------XX-------------XXXX------------X---XXX----XX----------------------------
--------------------XX-------XX-------------XXXX------------X---XXX----XX----------------------------
--------------------XX-------XX--------X----XXXX------------X---XXX----XX---------EE--EE-------------
XXXXXXXXXXXXXXXXXXXXXXXX-----XXXXXXXXXXXXXXXXXXXXXXXXXX-XXXXX---XXX---XXXXXXXX--XXXXXXXXXXXXXXXXXXXX-
