-----------------------------------------------------------------------------------------------------
-----------------------------------------------------------------------------------------------------
-----------------------------------------------------------------------------------------------------
-----------------------------------------------------------------------------------------------------
----------------------------C------------------------------------------------------------------------
--------B-------------------------------XX---------------------------B-------------------------------
-----------------------------------------------------------------------------------------------------
BB--C-----X--------------------------------------------------------------------E--------------C------
X---------------E--E--------------------------------BB------------------------XX---------------------
X-BB-----------XX-XX-------------------------------------------------B--------XX-------------B-------
X--------------XX-XX--------------X-------------------------------------------XX---E-E--------------X
X--BBB---------XX-XX-------------XX-------------------------------------------XX--XXXXXX-----------XX
X--------E-E---XX-XX--------E---XXX---------------------X-------------------E-XX--XXXXXX----------XXX
------XXXXXXXXXXXXXXXXXXXXXXXXXXXXXXXXX---XXXXXXXX--XXXXXXXXXXXXXXXXXXXXXXXXXXXXXXXXXXXXXXXXXXXXXXXXX
