-----------------------------------------------------------------------------------------------------
-----------------------------------------------------------------------------------------------------
-----------------------------------CC----------------------------------------------------------------
------------------------------C----XXX--------------------CC-----------------------------------------
----------C------------------------------------------------------------------------------------------
-XXXXXX---X------------------BB-----------------------------XXX----------E-----B-----B------XX-------
-----------------------------------------------------------------------------------------------------
-----------------------------------------------------------------------------------------------------
-------X-----------------------------------------------------------------EXBB------------------C-CCC-
------------XX------------E--B--------------------------X---------------XXXX--XXX-BPBB----------C---C
---------P---------------XX--------XXXXX--------------------------------XXXX--X----------------------
X------------------------XX---------------------------------------------XXXX--X----------------------
-------------------------XX---E--------------EE---EE-------------X------XXXX--X---------E------------
---------XX----XXXXXXXXXXXXXXXXXXX-------XXXXXXXXXXXXXXXX------XXXXXXXXXXXX---XXX-XXXXXXXXX---XXXXXXX
