---------------------------------------------------------------------------------------------------------------------
---------------------------------------------------------------------------------------------------------------------
---------------------------------------------------------------------------------------------------------------------
---------------------------------------------------------------------------------------------------------------------
---------------------------------------------------------------------------------------------------------------------
----------------------C--------------------------------CC------C-------------------------------C---------------------
-----------CC----------------------------------C------C------C---C---------C---CCC-------C-------C-------------------
-------C--C--C-C-------CCC--C-----C--C--C---CC-----------C--C-C------C------C-------C--C-----------C-----------------
--------C--------CC-------------------C-------BBB-C--C----C-----BBC---CC-----------C-CC-C----------------------------
------C--CB-BBC-C---CC----CC-----C---------B-P------C-------------BBPB---C--------C---PBB----------------------------
-------BBP----------------BPBB---------------------C--------------------C--------------------C-----------------------
-----------------------EE------PPB-------------EE-B---E----------S-----B------------------PPBB-EEE-------------------
-----------ES---------XXXX----------------S---XXXX----XXXX-SE-XXXXE----------EE----------S----XXXX----XXXX-----------
------E---XXXX---SE---XXXX---E-----E-E---EXXXXXXXX----XXXXXXXXXXXXXXXX----XXXXXXXX-SE-XXXX----XXXXEE--XXXX-----------
XXXXXXXXXXXXXXXXXXXXXXXXXXXXXX----XXXXXXXXXXXXXXXX----XXXXXXXXXXXXXXXX----XXXXXXXXXXXXXXXX----XXXXXXXXXXXX-----------
