--------------------------------------------------------------------------------------------------------------------
--------------------------------------------------------------------------------------------------------------------
--------------------------------------------------------------------------------------------------------------------
--------------------------------------------------------------------------------------------------------------------
--------------------------------------------------------------------------------------------------------------------
------------------BBB---P-------------BBB-B------------------------------B-----BB-----------------------------------
--------------------------------------------------------------------------------------------------------------------
-----------------C--------------------------------------------------------------------------------------------------
--------------------------------------------------------------------------------------------------------------------
----------------PB------BB------------------------------------------------------------------B-----------------------
--------------------------------------------------------------------------------------------------------------------
---------------------------------------------------------------------------------------SXXX-------------------------
---------------------C---C----C--------------------------------------------------------EX-XC------------------------
XXXXXXXXXXXXXXXXXX---XXX--XXXXXXXXXXXXXXXXXXXXXXXXXXXXXXXXXXXXXXXXXXXXXXXXXXXXXX--XXXXXXXXXXXXXXXXXXXXXXXXXXXXXXXXXX
