---------------------------------------------------------------------------------------------------------------------
---------------------------------------------------------------------------------------------------------------------
---------------------------------------------------------------------------------------------------------------------
---------------------------------------------------------------------------------------------------------------------
---------------------------------------------------------------------------------------------------------------------
-------C---------------------------------------------------C----------------------C----------------------------------
------C-C---------------C-C--CC---------C-----------------C-C--C---C-C------C------C------------C--C-----------------
--------------------------------------C--C-----------------------CC-------C--C------C----------C-C-------------------
---------B-----CC--------C-CC--C-C--C-----CC--------------------C-----C-------C-CC---------C-------------------------
-----------C--C--------------BPBBP-C-----------------CCC-C-------PBB-B----B----C------C-C-C-CC-----------------------
----------C-CC---C--------------------------CC-C--CC--PB--------------BBPB-------------------------------------------
------S---BBB-BB--E----------------------E---PBBBPPBBB-----EE----------------------SE---BBPPB--S-S-------------------
XXXXXXXXXX--------XXXX-SS----EE-------XXXX----------------XXXX---ES----------E----XXXX--------XXXXXXXX---------------
XXXXXXXXXX--------XXXXXXXXXXXXXXXX----XXXX------------S---XXXXXXXXXXXX-SE-XXXX----XXXX--------XXXXXXXX---------------
XXXXXXXXXX--------XXXXXXXXXXXXXXXX----XXXX------------XXXXXXXXXXXXXXXXXXXXXXXX----XXXX--------XXXXXXXXXXXX-----------
