-----------------------------------------------------------------------------------------------------
-----------------------------------------------------------------------------------------------------
------------------------------------------------------CCC--------------------------------------------
-----------------------------------------------------------------------------------------------------
-----------------------------------------------------------------------------------------------------
---CCCC-----------------X-P----E-------E-E----------C-----C------------------------------------------
-----------------------XX-----XX---------------------------------------------------------------------
----------------------XXX-----XX--------------X-----------------------------E------------------------
---------------------XXXX-----XX--------------------XXXXXXXX---------------XX------------------------
X-X----XXX----------XXXXX-B---XXX----------XXX-----------------------------XX------------------------
X-------------E-----XXXXX--------------------------------------------------XX------------------------
X-------------------XXXXX--------------------XXXXXXX-----------------------XX------B-----------------
--------------------XXXXX-----E-------CCCCC-----------------------XX-------XX------b-XX--------------
------------XXXXXX-XXXXXXXXX-XXXXXXXX-XXXXX------------------XXXXXXXXXXXXX-XXXXXXXXXXXXXXXXXXX-XXXXXX
