--------------------------------------------------------------------------------------------------------------------
--------------------------------------------------------------------------------------------------------------------
--------------------------------------------------------------------------------------------------------------------
--------------------------------------------------------------------------------------------------------------------
--------------------------------------------------------------------------------------------------------------------
--------------------------------------------------------------------------------------------------BBB---------------
--------------------------------------------------------------------------------------------------------------------
--------------------------------------------------------------------------------------------------------------------
--------------------------------------------------------------------------------------------------------------------
------------------------B-----------XX---XX---------------------------------------------B----BB-----B---------------
--------------------------------XX--XX---XX---------------------------------------------E---------------------------
--------------------------------XXX-X----XX-------------------------------------------------------------------------
-------------------------------XXXXX----XXX------------------------------------------C------------CCC---------------
XXXXXXXXXXXXXXXXXXX-------------XXXXX---XXXXXXXXXXXXXXXXXXXXXXXXXXXXXXXXXXXXXXXXXXXXXXXXXXXXXXXXXXXXXXXXXXXXXXXXXXXX
