---------------------------------------------------------------------------------------------------------------------
---------------------------------------------------------------------------------------------------------------------
---------------------------------------------------------------------------------------------------------------------
---------------------------------------------------------------------------------------------------------------------
---------------------------------------------------------------------------------------------------------------------
--------------------------------C-------C------------C---------------------------------------C-----------------------
-----------------C------------C---C----C------------C---------------------CCC------C------C--------------------------
---------CC--C-C---------C--C----C-CC-C---C--------C--C---------C----C-------C----C----------------------------------
------CCC-----C-C-C--C-CC-C--CB-BB--------------C-PBBB-C----C-CC-CCC-----CPB--C-----CC-C-C---------------------------
------------C---------------------BB-------CCCC-------BP-----C---B--C----------C-----BC-C-----C-C--------------------
------BBBP----------------BBBB-----------------C----------CC------BBBBBBPB-----------------------C-------------------
------------------------------E---------S-------PB---E-----------------------E--------P-P-E-------SE-----------------
-----------------S-----ES-----XXXX-EE-XXXX--------XXXXS----------E--------XXXX-----EE-----XXXX----XXXXXXXX-----------
------S----S-SXXXXS---XXXX---EXXXXXXXXXXXXE-------XXXXXXXX----XXXXS----ES-XXXX----XXXX----XXXX----XXXXXXXX-----------
XXXXXXXXXXXXXXXXXXXXXXXXXXXXXXXXXXXXXXXXXXXXXX----XXXXXXXX----XXXXXXXXXXXXXXXX----XXXX----XXXX----XXXXXXXX-----------
