--------------------------------------------------------------------------------------------------------------------
--------------------------------------------------------------------------------------------------------------------
--------------------------------------------------------------------------------------------------------------------
--------------------------------------------------------------------------------------------------------------------
--------------------------------------------------------------------------------------------------------------------
------------------------------------------------------------------------------------------------BBBBB---------------
--------------------------------------------------------------------------------------------------------------------
----------------------------------------------------------------------------------------------C---------------------
--------------------------------------------------------------------------------------------------------------------
----------------------------------X--X---X-----------------------------------P------P--P----BBB---------------------
--------------------------------XXX------X--------------------------------------------------------------------------
--------------------------------XXX-----XX---------------------------------------------SXX--------------------------
-------------------------------XXXX--X--XXX--------------------------------------------EEX--------------------------
XXXXXXXXXXXXXXXXXXXXX----------XXXXXXXXXXXXXXXXXXXXXXXXXXXXXXXXXXXXXXXXXXXXXXXXXXXXXXXXXXXXXXXXXXXXXXXXXXXXXXXXXXXXX
