---------------------------------------------------------------------------------------------------------------------
---------------------------------------------------------------------------------------------------------------------
---------------------------------------------------------------------------------------------------------------------
---------------------------------------------------------------------------------------------------------------------
---------------------------------------------------------------------------------------------------------------------
-----------------------------------------C------------C-------C-CC----------------------------CC---------------------
-------------CC-------------------------C-C---C-----CC---------------------------C------C-C-C------C-----------------
-----------CC----C----------C-CC-----CCC---CC--C--C----C-------C--------------CCC-CC---------C--CC-------------------
--------C------CC--CCC-----------C------------B-BB---------C---PBB-------C---C-------C----BP-B-----------------------
-----------------------CC-PBBB--C-CCC--------B--------------C-------C------C--------C---BB---------------------------
------CC----------------BB----B-B-------------------------C--C----CC------BBBB---------------------------------------
--------PB-EE----------------------------E----E-S----SS----------EBPP--BBB----E-----------S----S---------------------
XXXXXX----XXXX---ES----------S--------XXXXE---XXXXXXXXXXXX----XXXX------------XXXX-------EXXXXXXXXSS-----------------
XXXXXX----XXXXXXXXXXXX-EE-XXXXE----SE-XXXXXXXXXXXXXXXXXXXX----XXXX-----------SXXXX-EE-XXXXXXXXXXXXXXXX---------------
XXXXXX----XXXXXXXXXXXXXXXXXXXXXXXXXXXXXXXXXXXXXXXXXXXXXXXX----XXXX--------XXXXXXXXXXXXXXXXXXXXXXXXXXXX---------------
