---------------------------------------------------------------------------------------------------------------------
---------------------------------------------------------------------------------------------------------------------
---------------------------------------------------------------------------------------------------------------------
---------------------------------------------------------------------------------------------------------------------
---------------------------------------------------------------------------------------------------------------------
------------------------------------------------------------------C--------------------------------------------------
-----------C-----------------------C----------------C----------C-----------------------------------------------------
-------C--C-CC------------------CCC--C----C---CC---C------------CC-CC---C-------------CC-----------------------------
--------C---------CC-CC-C------BB---C--C--------C-BBBBP---C-CC-----BPB-C-C--------CCC---C-------C-CC-----------------
---------CBPP---C---------C-----------C------C-BB-------------------------CC-C--C----CPBBPC--C-C---------------------
-----------------------C-C-C-----------------B-------------C----------PPP--------C------------C----------------------
----------------------B-BBPBPB-E---------------------EE-----------S---------------BBB-----B--------------------------
-----------ES-----------------XXXX-EE----------SS-XXXXXXXX------E-XXXX-------------------E------------XXXX-----------
------E---XXXX----S-----------XXXXXXXX---SE---XXXXXXXXXXXX----XXXXXXXX-EE-------------XXXX------------XXXX-----------
XXXXXXXXXXXXXX----XXXX--------XXXXXXXXXXXXXXXXXXXXXXXXXXXX----XXXXXXXXXXXX------------XXXX------------XXXX-----------
