---------------------------------------------------------------------------------------------------------------------
---------------------------------------------------------------------------------------------------------------------
---------------------------------------------------------------------------------------------------------------------
---------------------------------------------------------------------------------------------------------------------
---------------------------------------------------------------------------------------------------------------------
------C--C------------------------------------------C----------------------------------------------------------------
-------------------------------------------C---C-C-----C--CC----C----------------------------------------------------
-------C------------------C-----------C---C--------C-CC-------C----C-C-C--------C------------------------------------
------BBPB--------C---C-C--C-----CC-----CC----C-C---BP--C----C-C--C-C-----C-C---------C--CC-C------------------------
----------C-CCC-CC-C-C-C--------C---C---------BB--------------------B---C--C------CC---------------------------------
----------B-------------BBBPB-----------------------------------------BBB------------C-CC--C-C---C-------------------
------E-----------------------BBBB-------------------E---------------------P--E-------PB---BBB-----------------------
XXXXXXXXXX-------------------------------ES----EE-XXXXS----ES----EE-----------XXXX-----------------------------------
XXXXXXXXXX-EE----EE----EE----E-----SE-XXXXXXXXXXXXXXXXXXXXXXXXXXXXXXXX-EE-----XXXX-----------------------------------
XXXXXXXXXXXXXXXXXXXXXXXXXXXXXX----XXXXXXXXXXXXXXXXXXXXXXXXXXXXXXXXXXXXXXXX----XXXX-----------------------------------
