---------------------------------------------------------------------------------------------------------------------
---------------------------------------------------------------------------------------------------------------------
---------------------------------------------------------------------------------------------------------------------
---------------------------------------------------------------------------------------------------------------------
---------------------------------------------------------------------------------------------------------------------
---------------------------------------------------CC-------CC-----------C-----CC------------------------------------
---------C---C----------------CC------C--C----C-C---------CC----C-CC---C---------------------------------------------
------C-------------------------C----------------C---C--C---------------C---------C----------C----C------------------
-------BP-CCC-C--C--------C-------C-------CC-------P---C-C----------C-B----C-------C----C--CC------------------------
----------B----C------CCC-----PBBP-----------CB-BB----C----------BBBB----------------C---------C-C-------------------
---------------------------CC-------CC------------------------------------C-CC-------BCC--BBBB--C--------------------
------E-----------E-----P-PB-P----B------E--BB-------E-----EE----------ES-----E-------B-PB----P---ES-----------------
XXXXXXXXXX-EE-----XXXX--------E-------XXXX-----EE-XXXX----XXXX---ES---XXXX----XXXX----------------XXXX---------------
XXXXXXXXXXXXXX----XXXX--------XXXX----XXXX----XXXXXXXXS---XXXXXXXXXXXXXXXX----XXXX-EE-----S-------XXXX---------------
XXXXXXXXXXXXXX----XXXX--------XXXX----XXXX----XXXXXXXXXXXXXXXXXXXXXXXXXXXX----XXXXXXXX----XXXX----XXXX---------------
