-----------------------------------------------------------------------------------------------------
-----------------------------------------------------------------------------------------------------
-----------------------------------------------------------------------------------------------------
--------------------------------------------------------------------XX-------------------------------
--------------------------------------------------------------------XX-------------------------------
--------------------------------------------------------------------XX-------------------------------
--------------------------------------------------------------------XX-------------------------------
--------------------------------------------------------------------XX-------------------------------
-----------P-----------------------------------------------------E--XX--------------------E---E------
X---XX--------------------------------------------------------E-XX--XX-------------------XX--XX------
------------------------X-------------------------------------E-XX--XX-----------------B-XX--XX------
-----------------------XXX--------------------------------------XX--XX-----------------b-XX--XX------
-----------------------XXX----------------E---------------------XX--XX-------------------XX--XX----E-
X-XX------XXXX-XXXXXXXXXXXXXXXXXXXXXXXXXXXXXXXXXXXXXXXXXXXXXXXXXXXXXXXXXXXXXXXXXXXXXXXXXXXXXXXXXXXXXX
