---------------------------------------------------------------------------------------------------------------------
---------------------------------------------------------------------------------------------------------------------
---------------------------------------------------------------------------------------------------------------------
---------------------------------------------------------------------------------------------------------------------
---------------------------------------------------------------------------------------------------------------------
--------------------------C-CC--------------------------------------------C-C-----C--C-------------------------------
-------------CCC-----------C----CC----CC-----------------------C-C------------C-C--C---------------------------------
------C---CCC---C---C----------C---C-C--C------CC-------------C-C----------C-C-C----C--------C-----------------------
--------CCBB------------C-BBPP-BB-C-C----C-----------C-C-----C------C-----PP-----C--B-C---------C--------------------
-------C------------------------------------C-C--C--------C-------------CC-------------C-CCC-----C-------------------
--------BB--------------P---------B-------C--C--BB----C--C--------CC-C-BPP------------P-BPB-PB-C--C------------------
-----------ES----------------EE-------------------BB----------------BP-------E-----ES---------P----B-----------------
----------XXXX---E--------XXXXXXXX-------S-----------------------S--------XXXXE---XXXX----------------XXXX-----------
------S---XXXXXXXXE----SE-XXXXXXXX-S-EXXXX-----SE-------------XXXX-----ES-XXXXXXXXXXXX---EE-----------XXXX-----------
XXXXXXXXXXXXXXXXXXXXXXXXXXXXXXXXXXXXXXXXXX----XXXX------------XXXX----XXXXXXXXXXXXXXXXXXXXXXXX--------XXXX-----------
