-----------------------------------------------------------------------------------------------------
-----------------------------------------------------------------------------------------------------
-------C---------------------------------------------------------------------------------------------
------XXX--------------------------------------------------------------------------------------------
-----------------------------------------------------------------------CCCCCCCCCCCCCCC---------------
----------XXXXXX-----------------------------------------CC--------X--------------------X------------
C-E-------XXXXXX-------------------------------------------------------------------------------------
XXXX------XXXXXX------------------------------------------------------------------XX-------------XBB-
----------XXXXXX------E------------------E------------------------------------------------------XXX--
---CCC----XXXXXX-BB--XX----XXX---E------XX--------B--XXXX--XX--XXXXXX----------------XXX----X--XXXX-B
-----E----XXXXXX-----XX---XXXX--XX------XX-------------------------------------------------XX-XXXXX--
XXXXXXX---XXXXXX-E---XX--XXXXX--XX------XX------------------------------------------------XXXXXXXXX--
----------XXXXXX-----XX-XXXXX---XX------XX------X-----------------------------------------XXXXXXXXX--
----------XXXXXXXXXXXXXXXXXXX---XXXXXXXXXXXXXXXXXXXX-------------------XXXXXXXXXXXX-----XXXXXXXXXX---
