---------------------------------------------------------------------------------------------------------------------
---------------------------------------------------------------------------------------------------------------------
---------------------------------------------------------------------------------------------------------------------
---------------------------------------------------------------------------------------------------------------------
---------------------------------------------------------------------------------------------------------------------
-----------------------CC------------------CC---------------------------C----------------------CCC-------------------
--------------CCC--C-----CC-----------------------C-----C---C-------------C-------------------C----------------------
-----------C---------C-----CC---C---------C---C----CC-C--CC--C--------CC----C----------C--CC-------------------------
--------------------C----P-------C-C-----C--BB-C----BB-C----------C-C-BBPB------C-C--C------------C------------------
------CCCC-BP-------------BBPBC---C-----C-------C-----B-------------------BBB-------C-BBPB---------------------------
------BPBB--------------------B-----CCC-------PBBB--------------CC---------------C--------B--------------------------
-----------------S-----SS-----------------E----------E-----ES-------B--SE----------------------E-E-------------------
-----------SS-XXXXE---XXXX---S------------XXXX----XXXXE---XXXX--------XXXX---E-----------S----XXXX-E-----------------
------E---XXXXXXXXXXXXXXXXXXXXS-----------XXXX-EE-XXXXXXXXXXXX--------XXXXXXXX-----SE-XXXXE---XXXXXXXXXXXX-----------
XXXXXXXXXXXXXXXXXXXXXXXXXXXXXXXXXX--------XXXXXXXXXXXXXXXXXXXX--------XXXXXXXX----XXXXXXXXXXXXXXXXXXXXXXXX-----------
