---------------------------------------------------------------------------------------------------------------------
---------------------------------------------------------------------------------------------------------------------
---------------------------------------------------------------------------------------------------------------------
---------------------------------------------------------------------------------------------------------------------
---------------------------------------------------------------------------------------------------------------------
-------CC----------------------------------------------C-C-----------------------------------------------------------
-----------C------C----CC------------------------C----------------------CCC-------C----------C-----------------------
------------C--C-C------------------------CC-CC-----C---C-----------C--C-----------CC-------C--C---------------------
---------BBBB------CC-C--C--C----C--CCC--------CC--C------------C----------C-----C----C-CC------CCC------------------
-----------------------B-B----C-C-C-------------P----------C---C-CCC--B-------C-C----B----PBPP-----C-----------------
---------------------------C-------B--------------BBPB----C--C----BP-------------------C-----------------------------
------E----SS---------------PB-PBB--------E-----------S----------B--------------------P-BB---------------------------
XXXXXXXXXXXXXX---ES----SE-----------------XXXX-SE-----XXXX-------------ES----S-----EE-----E-----------XXXX-----------
XXXXXXXXXXXXXXXXXXXXXXXXXX---------EE-----XXXXXXXX---EXXXX--------E---XXXXXXXX----XXXX----XXXX-EEE----XXXX-----------
XXXXXXXXXXXXXXXXXXXXXXXXXX--------XXXX----XXXXXXXXXXXXXXXX--------XXXXXXXXXXXX----XXXX----XXXXXXXX----XXXX-----------
