---------------------------------------------------------------------------------------------------------------------
---------------------------------------------------------------------------------------------------------------------
---------------------------------------------------------------------------------------------------------------------
---------------------------------------------------------------------------------------------------------------------
---------------------------------------------------------------------------------------------------------------------
-------C----------C-------------------------------C--CC-C----------------------------------C-C-----------------------
------C------------C-----C-------C------------C--------C-C-C-C-------C--C-------------C-C-C-C-CC---------------------
--------------CCC----CCCC------------C------C---C--CC-----C-C-----C-C----C---C-CCC---------------C-------------------
---------P-C-------------P--CCC-------C-C-C-----P--BP---P-------CC--------C-C-------C-----BBB---C--C-----------------
----------C--C---C--------CC--PB---C-------C-C---------------------B-BBBPB-C---------C-------------------------------
------------C--------------BBB----BPBP------------------------------------BB-------C--------------C------------------
------E----PP-----E----EE-------------B--------ES----ES----------B-----------------------SE--------------------------
XXXXXXXXXX--------XXXXXXXX----E---------------XXXXXXXXXXXX-SS-----E----EE-----E-------XXXXXXXX-SES-------------------
XXXXXXXXXX-------SXXXXXXXX---EXXXX-SE-----E---XXXXXXXXXXXXXXXX----XXXXXXXX---EXXXX----XXXXXXXXXXXX-------------------
XXXXXXXXXX----XXXXXXXXXXXXXXXXXXXXXXXX----XXXXXXXXXXXXXXXXXXXX----XXXXXXXXXXXXXXXX----XXXXXXXXXXXX-------------------
