-----------------------------------------------------------------------------------------------------
-----------------------------------------------------------------------------------------------------
----------------------------------------------------------------------------------E------------------
-----------------------------------------------------------------------------------------------------
------------------------------X----------------------------------------------------------------------
------------------B-------------X--------------C-------B---------------------------------------------
-------CC-----------------------X----XXX-------------------------------------------------------------
--------------------------------X------------------------------E-------------------------------------
XX---X-------------------XXXXX--X-------------------------E---XX-------------------------------------
-------------BBBBPB-------------X---------------XXXXX---EXX---XX-B---------------------E-------------
--------------------------------X----------------------XXXX---XX-----------------------E-------------
--------------------------------X----------------------XXXX---XX---B---------B-----------------------
C----------------E-EE----CCC----X----------------------XXXX---XX---b---------b----XX-------------E---
X-----XXXXXXXXXXXXXXXXXXXXXX----XXXX-------XXX-----X--XXXXXXXXXXXXXXXXXXXXXXXXXXXXXXXXXXXXXXXXXXXXXXX
