---------------------------------------------------------------------------------------------------------------------
---------------------------------------------------------------------------------------------------------------------
---------------------------------------------------------------------------------------------------------------------
---------------------------------------------------------------------------------------------------------------------
---------------------------------------------------------------------------------------------------------------------
--------------C-CC--------------------------CC---------------------------------------------C-------------------------
---------C------------------------------C-C---C----------C-----------------------------------------------------------
------C-C--C-C---------C--C-------C----C---------------C------CC----CC------C--C-------------CC-C--------------------
-------C--C-------C---C----C----CC--C----C-----C---C----C-CC-----------------C------C-C-C-B--P----CC-----------------
------BBB-BBB--------C-----B-B-C---C------------P---C--BB---C---BB-C---C---C------CC-C-C-C-------C-------------------
------------------------------PBBP----------------BB---------C----BB-B--CC--------------BB---------------------------
-----------------E------------------------S---------------------------BB------E-----------E--------------------------
------E----EE-XXXX-----S-E---E-----------EXXXX-EE-----E----------E------------XXXX--------XXXX-----------------------
XXXXXXXXXXXXXXXXXXE---XXXXXXXXE----SE-XXXXXXXXXXXX---EXXXX----XXXXE----------EXXXX-------EXXXX-ES-S------------------
XXXXXXXXXXXXXXXXXXXXXXXXXXXXXXXXXXXXXXXXXXXXXXXXXXXXXXXXXX----XXXXXXXX----XXXXXXXX----XXXXXXXXXXXXXXXXXXXX-----------
