---------------------------------------------------------------------------------------------------------------------
---------------------------------------------------------------------------------------------------------------------
---------------------------------------------------------------------------------------------------------------------
---------------------------------------------------------------------------------------------------------------------
---------------------------------------------------------------------------------------------------------------------
----------------------------------------------------C-----CCC--------------------------------------------------------
------------CC----------C---C-----------------CCC----C---------------------------------------------------------------
-------C--------C-C---CC-------------------------------------C--------C-CC-----------------CC------------------------
------C-C-CC--CC-C-C-----CC----C---C--C--C---CBBBBBB-BC-----------C-C--C---C--C-C----CCCC----C---C-C-----------------
-----------P-----------BP-PB-P---C-----C--CC------------CC----C--C---C----C--C------------B-----C-C------------------
-------PBB----------------------------------C----------C-------C---C---PB---C-------C----------C---------------------
------------------------------BPBB----------PP-SS----E-----ES------B-B------------------P----------------------------
-----------SE----EE----SS----E----------------XXXXXXXX----XXXX----------------E-----------E--------------------------
------S---XXXXXXXXXXXXXXXXXXXX----------------XXXXXXXX----XXXX---------EE-----XXXX--------XXXX-----E-----------------
XXXXXXXXXXXXXXXXXXXXXXXXXXXXXX----------------XXXXXXXX----XXXX--------XXXX----XXXX--------XXXX----XXXX---------------
