-----------------------------------------------------------------------------------------------------
-----------------------------------------------------------------------------------------------------
-----------------------------------------------------------------------------------------------------
-------------------------B---------------------------------------------------------------------------
X----------------------------------------------------------X--CCC------------------------------------
------------------------------------------------------------------------------------XXXXX------------
-----------------------XX-----------------------------------------------------------XXXXX------------
-----------------------------------------------------------------------------------XXXXXX------------
----------------P------------------------------------E-----------------------------XXXXXX------------
--B---------------XX------------E---------X---------XX-EB-----------------E--------XXXXXX------------
X--------------------XXX-------XX---------XX--------XX-------------------XX-------XXXXXXX-------E----
-----------X------------------------------XX-------XXX-------------------XX--XX-XXXXXXXXX------XX----
----------XX-----------------E-----X-E----XX-E----XXXX--------EEE--------XX--XXXXXXXXXXXX-X--E-XX----
--XXXXXXXXXXXXXXXX----------XXXXXXXXXXXXXXXXXXXXXXXXXXXXXXXXXXXXXXXXXXXXXXXXXXXXXXXXXXXXXXXXXXXXXXXXX
