-----------------------------------------------------------------------------------------------------
-----------------------------------------------------------------------------------------------------
BBBBBBBBBBBBBBBBBBBBBBBBBBBBBBBBBBBBBBBBBBBBPBBBB----------------------------------------------------
---BBB-----------------------BBBBB-------------------------------------------------------------------
---BBB-----------------------BBBBB-------------------------------------------------------------------
----BB--------------B----------------------CC---------------------------B----------------------------
----BB-----------------------------------------------------------------------------------------------
----BB-------------------------------------BB-----CC-------------------------------------------------
----BB--------------------B---E------------BB---------------------------------E----------------------
E---BB--------------B--------BBBBB-------E-----BB-----B------E--------BPBBB--XX----------------------
X-----------------E---------EE----------XX------------------XX------E--------XX----------------------
X----------------XX---------------------XX------------------XX-----XX--------XX-----B----------------
X----E--------E--XX---------------------XX------------------XX-----XX--E-----XX-----b-----------E----
XXXXXXXXXXXXXXXXXXXXXXXXXXXXXXXXXX--XX-XXXXXXXXXX--XXXXXXXXXXXXXXXXXXXXXXXXXXXXXXXXXXXXXXXXXXXXXXXXXX
