-----------------------------------------------------------------------------------------------------
-----------------------------------------------------------------------------------------------------
BBBBBBBB---------------------------------------------------------------------------------------------
-------------------------------------C---------------------------------------------------------------
------------------------------------XXX--------------------------------------------------------------
--E------------E----XX-------------------------------------------------------X-----------CC-C--------
-XX-----------XX----XX-------------------------------------------------------X-----------------------
-XX-----------XX----XX-----------------------------------------B-------------X-----------------------
-XX-----------XX----XX-----------------------------------------b-----------E-X------------XXXX-------
BXXBBBBB------XXXXX-XX--------------------X------------------BBXB---------XX-X------------------E----
-XX-----------------XX----------E-----------------------------------------XX-X-----------------XX----
-XX-----------------XX----XX----------------------------------------------XX-------------------XX----
-XX-----------E-----XX----XX--X----------------EE-----EE------------X-----XX-------------------XX----
XXXXXXXX-XXXXXXXX---XXXXXXXXXXXXXXXXXXXXXX---XXXXXXXXXXXXX--XXXXXXXXXXXXXXXXXXXXXXXXXXXX------XXXXXXX
