--------------------------------------------------------------------------------------------------------------------
--------------------------------------------------------------------------------------------------------------------
--------------------------------------------------------------------------------------------------------------------
--------------------------------------------------------------------------------------------------------------------
--------------------------------------------------------------------------------------------------------------------
----------------------------------------------------------------------------BBB-------------------------------------
--------------------------------------------------------------------------------------------------------------------
---------------------------------------------------------------------------C----------------------------------------
--------------------------------------------------------------------------------------------------------------------
-------------------BBB-B-----SXX--BBB-------------------------------------BB------B---------------------------------
-----------------------------EEX------------------------------------------------------------------------------------
-----------------------------EEX------------------------------------------------------------------------------------
----------------C-C-C---C--C-EEX-----------------------------------------------C----------E---------X---------------
XXXXXXXXXXXXXXXXXXXXXXXXXXXXXXXXXXXXXXXXXXXXXXXXXXXXXXXXXXXXXXXXXXXXXXXXXXXXX-XXXXX-XXXXXXXXXXXXXXXXXXXXXXXXXXXXXXXX
