---------------------------------------------------------------------------------------------------------------------
---------------------------------------------------------------------------------------------------------------------
---------------------------------------------------------------------------------------------------------------------
---------------------------------------------------------------------------------------------------------------------
---------------------------------------------------------------------------------------------------------------------
----------------------------------C-C------------------C-------------------------------------------------------------
-----------------------------------C------------------------C-------------C-----C-----C-C-CCCC-----------------------
------------------C------------------C-C---C--C-------C-CCCC-----------C---C------C-C--C--------C--------------------
---------C---------CC-CC--C--C---C-----------C-C-------B------C--CC----------------C-----C-----C-C-------------------
-------C---CCCCC-----C----------------C-----------C--C---------CC--C-CC-CC----------PBBBPB---------------------------
--------B-C-----CC----------C--C-------------P-B-----------------BBB-B----------------------------C------------------
----------PBB-BBB------PP-BBPPBB---EE--------------B-BS----EE-----------------E--------------------------------------
----------------------------------XXXX----------------XXXXXXXX---------------SXXXX-EE----SS----EE-----XXXX-----------
------S-----------E---------------XXXX---EE----ES-----XXXXXXXX---SS----EE-XXXXXXXXXXXXXXXXXXXXXXXX----XXXX-----------
XXXXXXXXXX--------XXXX------------XXXXXXXXXXXXXXXX----XXXXXXXXXXXXXXXXXXXXXXXXXXXXXXXXXXXXXXXXXXXX----XXXX-----------
