-----------------------------------------------------------------------------------------------------
-----------------------------------------------------------------------------------------------------
-----------------------------------------------------------------------------------------------------
-----------------------------------------------------------------------------------------------------
--------------CCCCCC-CC------------------------------------------------------------------------------
------------------------XCC--B-----------------------------------------------------------------------
-----------------------------------------------------------------------------------------------------
X-CC-----XXX----XX-----------------------------------------------------------------------------------
--------------------------XX-B----------------------------------------------------C------------------
-------------------XX-------------------------------------BB------------------------------XX---X-----
--------XX--------------------------E---------------------E------------------------------------------
----------------------XX-----------XX----------------------------------------------------------------
-----------------------------------XX-------------------------------------------------E--------------
---XXXXX------XXX-------------XXXXXXXXXXXXXXXXXXXXXXXXXXXXXXXXXXXXXXXXXXXXXXXXXXXXXXXXXXXX---XXXXXXXX
