---------------------------------------------------------------------------------------------------------------------
---------------------------------------------------------------------------------------------------------------------
---------------------------------------------------------------------------------------------------------------------
---------------------------------------------------------------------------------------------------------------------
---------------------------------------------------------------------------------------------------------------------
-------------C------CC--------C-----C-------C--------C------------C---------------C--C----------C--------------------
-------C----C------C-------------C-C-CC--C---C------C--------C-----CC---------C----CC---------C----------------------
------C---C----C--C-------C----C-------CC--C--------------CC---------C-------------------------C---------------------
---------CPPBB---------C------PBB-------------C----B---C-C----CC--PB-B--C------C---------C---------------------------
------BPPB----C--C---------C----------------------------C--------C----C---C--C--------C---C-CC-----------------------
---------------P------C-CC-B-------------------CC-----C---------------BBBB-CC----------CC-P-BP-----------------------
-----------SE-----E-----------E----SE----SE----BB----S------------S-------P--------EE-BB-B-----S---------------------
------E---XXXX----XXXX--------XXXXXXXXXXXXXXXX----XXXX-----EE-----XXXX--------S---XXXX--------XXXX-S--XXXX-----------
XXXXXXXXXXXXXX---SXXXX-------EXXXXXXXXXXXXXXXX----XXXX----XXXX----XXXX-EE-----XXXXXXXX----E---XXXXXXXXXXXX-----------
XXXXXXXXXXXXXXXXXXXXXX----XXXXXXXXXXXXXXXXXXXX----XXXX----XXXX----XXXXXXXX----XXXXXXXX----XXXXXXXXXXXXXXXX-----------
