-----------------------------------------------------------------------------------------------------
--------------------------------------------------------------------------------XX-------------------
BBBBBBBBBBBBBBBBBBBBBBBBBBBBBBBBBBBBBBBBBBBBBBBBBBBBBBBBBBBBBBBBBBBBBBBBBBBBBB-----------------------
B--------------------BBBBBBBBBBBBBBBBBBBBBBB----B---------BBBBBBBB-----------------------------------
B--------------------BBBBBBBBBBBBBBBBBBBBBBB-E--B---------BBBBBBBB-----------------------------------
---------------------BBBBBBBBBBBBBBBBBBBBBBB-BBB-----------B---B-------------------------------------
--------C------------------------------------BBB-----------B---B----------------------C--------------
---------------------------------------------BBB-----------B---B-------------------------------------
PP-----B-------------------------P--------E--BBB-----------BCCCBCPP----------------------------------
B----------------------BBBBBBBBBBPPBBBBBBBBB-BBBB----------BBBBBBB-----------------X-----------------
------X--XXXX-BBBBBB---BBBBBBBBB---BBBBBBBBB----B---------------------------XXXX---------------------
-----XX--XXXX-BBBBBB---BBBBBBBBB---BBBBBBBBB----B-------------------------XXXXXXXX-------------------
---XXXXE-XXXX-BBBBBB------------CCCBBBBBBBBB---E--E----------E---------E-XXXXXXX----XXXXXX----E------
XXXXXXXXXXXX--XXXXXX--XXXXXXXXXXXXXXXXXXXXXXXXXXXXXXXXXXXXXXXXXXXXXXXXXXXXXXXXX------------XXXXXXXXXX
