---------------------------------------------------------------------------------------------------------------------
---------------------------------------------------------------------------------------------------------------------
---------------------------------------------------------------------------------------------------------------------
---------------------------------------------------------------------------------------------------------------------
---------------------------------------------------------------------------------------------------------------------
-----------------------------------------------------------------C-------------------C-------------------------------
----------------C------C-C-----------------C---------------CC---------C------C----------------CC---------------------
---------C--C-C------C-----C--------------C--C----------C-----CC--C--C------------CCC--------C-----------------------
-------CC-C---------C----------CCC-------------C--C-CCC--C-----BB---C--C-C-C-----C---B-CCC---------------------------
-----------C--B---------------C---C---------PB---C----------------P-PBB-------C-------C----C-------------------------
-------BBBBBP------------------------------------------------------------------C------BBBPBBB------C-----------------
-----------------------EE-----PBBB------------BBBB-BBB-----------E-----------------SE--------------------------------
-----------------ES---XXXX---S------------E----------------ES-XXXXE----SE----E----XXXX---------EE-----XXXX-----------
------S----SS-XXXXXXXXXXXXXXXX------------XXXX--------S---XXXXXXXXXXXXXXXXXXXX----XXXX---EE---XXXX----XXXX-----------
XXXXXXXXXXXXXXXXXXXXXXXXXXXXXX------------XXXX--------XXXXXXXXXXXXXXXXXXXXXXXX----XXXXXXXXXXXXXXXX----XXXX-----------
