-----------------------------------------------------------------------------------------------------
-----------------------------------------------------------------------------------------------------
BBBBBBBBBBBBBBBB-------------------------------------------------------------------------------------
---------------------------------------------------E-------------------------------------------------
----------------------------CC--------------------XXXXX----------------------------------------------
---------------------------------------------C-C-------------------------------------------BBBBBB----
-----------------------------------------------------------------------------------------------------
-----------------------------------------------------------------------------------------------------
P------------------CCCCC--X------------------XXXXX----------X------------------XX--------------------
-----------E-BBB-----------------------------------------X-XX---------------E------------------------
----------XX---------------------------------------------XXXX------XXXXXXXXXXXXX--------------------E
----------XX-----------------XXXXXXXXXXXXXXXX------------XXXX----------------------------------------
----------XX-------------X-------------------------------XXXX---------------------------E-E----------
XXXXXXXXXXXXXXXX------X----------------------------------XXXXXX-------------------XXXXXXXXXXX----XXXX
