-----------------------------------------------------------------------------------------------------
-----------------------------------------------------------------------------------------------------
BBBBBBBBBBBBBBB---------------------CCCCCCCC---------------------------------------------------------
--------BBBBB---------------E-------XXXXXXXXX--------------------------------------------------------
--------BBBBB------------XXXXXXX----------------CC---------------------------------------------------
--------BBBBB--------C------------X-------------XX-------------------------------BBBBB-------------E-
---C----------------------------------------------------------C--------------------------------------
-----------------------------------------------------------------------------------------------------
--B----------------XXXXXX-----------------------------XX---------------------X---------------------EX
-------------XXX-------------------------------------EXX--X-----------------XX---BBBBB---B--------XXX
XX--XX------XXXX--XX----------------XXXXXXXXXXXP----XXXX--X--------------X-XXX--------------------XXX
XX--XX-----XXXXX-----------------X------------------XXXX--X-------------XXXXXX--------------------XXX
XXE-XX----XXXXXX------------------------------------XXXX--X------E-----XXXXXXX--------------------XXX
XXXXX----XXXXXX--------------------------------XXX--XXX---X---XXXXXXXXXXXXXXXXXXXXXXXXX--XXXXXXXXXXXX
