--------------------------------------------------------------------------------------------------------------------
--------------------------------------------------------------------------------------------------------------------
--------------------------------------------------------------------------------------------------------------------
--------------------------------------------------------------------------------------------------------------------
--------------------------------------------------------------------------------------------------------------------
------------------BB----------------BBBBBBB---------------------------------BBBP------------------------------------
--------------------------------------------------------------------------------------------------------------------
--------------------------------------------------------------------------------------------------------------------
--------------------------------------------------------------------------------------------------------------------
----------------BB-----P--P--P-----BB-------------------------------------PB------BP--------X-XX--------------------
------------------------------------------------------------------------------------------XXXXXX--X-----------------
-----------------------------------------------------------------------------------------XXXXXXXXXXX----------------
-----------------------C-------------------------------------------------------C---------XXXXXXXXXXX----------------
XXXXXXXXXXXXXXXXXXXXXXXXXXXXXXXXXXXXXXXXXXXXXXXXXXXXXXXXXXXXXXXXXXXXXXXXXXXX---XXX----XXXXXXXXXXXXXXXXXXXXXXXXXXXXXX
