---------------------------------------------------------------------------------------------------------------------
---------------------------------------------------------------------------------------------------------------------
---------------------------------------------------------------------------------------------------------------------
---------------------------------------------------------------------------------------------------------------------
---------------------------------------------------------------------------------------------------------------------
------C--C----------------------C----------CC---C----------------C-C--C-C--------------------------------------------
--------C---CC-------CC----------C-----------C---------C------C-----C------------------------------------------------
-----------C-------C---C-------C----------C---CC-C------C-C----CC-C----C-C-C------------------CCC--------------------
------BPBPB--PC---C-----CC----BB-------CCC-BPB-BBP-C--C--C---C------PBP---C-C--C----C-----C-CC---CC------------------
----------------C---------C-C-----C-C-------------C-CCP----------------------C----CC-CCC-----------C-----------------
---------------C-C----------BB-------C------------PBPB-------------------------------B---C---------------------------
------E----EE-----------------E-----------E----EE----------------ES----ES-------------PPBBBBP------------------------
XXXXXXXXXXXXXX----E----ES-----XXXX--------XXXXXXXX----E----SS-XXXXXXXXXXXX-------------------------------------------
XXXXXXXXXXXXXX----XXXXXXXX---EXXXX-------EXXXXXXXX---EXXXXXXXXXXXXXXXXXXXX---S-----EE----------SES-------------------
XXXXXXXXXXXXXX----XXXXXXXXXXXXXXXX----XXXXXXXXXXXXXXXXXXXXXXXXXXXXXXXXXXXXXXXX----XXXX--------XXXX-------------------
