---------------------------------------------------------------------------------------------------------------------
---------------------------------------------------------------------------------------------------------------------
---------------------------------------------------------------------------------------------------------------------
---------------------------------------------------------------------------------------------------------------------
---------------------------------------------------------------------------------------------------------------------
------------------------------------C-------C---------------------C-------------CC------C----------------------------
------------------------------C---C--C----C---C-----C--CC------------C--------C-----------C--------------------------
------------------CC-C---------------------C----C------------------CC------------------C-C--C--CC--------------------
----------C--C--C-----------CC--C-----CC-------C-----C--------C----BBB-------C--------PBB--C-CC----------------------
--------------CC---------C----BB--------------PBP-BPBBBBB--C---C----------CCC-----C-CC----B------C-------------------
------C--C------------CCC---------------CC----------------------CC-----C-CB------------------------------------------
------BBBBBP------E---------B------ES-----E-----------------------E----BBB----E----------E--------S------------------
------------------XXXX--------E---XXXX----XXXX-ES----SE-----------XXXX--------XXXX----XXXXE-------XXXXXXXX-----------
-----------------EXXXX--------XXXXXXXX----XXXXXXXXXXXXXXXX--------XXXX-------EXXXX-EE-XXXXXXXX-EEEXXXXXXXX-----------
XXXXXX--------XXXXXXXX--------XXXXXXXX----XXXXXXXXXXXXXXXX--------XXXX----XXXXXXXXXXXXXXXXXXXXXXXXXXXXXXXX-----------
