--------------------------------------------------------------------------------------------------------------------
--------------------------------------------------------------------------------------------------------------------
--------------------------------------------------------------------------------------------------------------------
--------------------------------------------------------------------------------------------------------------------
--------------------------------------------------------------------------------------------------------------------
------------------------------------BBBBB-B-----------------------------------BB------------------------------------
--------------------------------------------------------------------------------------------------------------------
-----------------------------------C--------------------------------------------------------------------------------
--------------------------------------------------------------------------------------------------------------------
-------------------BB--P-----SXX---------------------------------------------BB-------------X--X--------------------
-----------------------------EEX------------------------------------------------------------X-----------------------
-----------------------------EEX--------------------------------------------------------SXXXX---XXX-----------------
----------------C-C----------EEX-------C-------------------------------------------C----E-XXX---XX------------------
XXXXXXXXXXXXXXXXXXXXXXXXXXXXXXXXXXXXXXXXXXXXXXXXXXXXXXXXXXXXXXXXXXXXXXXXXXXXXXXXXXXXXXXXXXXXXXXXXXXXXXXXXXXXXXXXXXXX
