-----------------------------------------------------------------------------------------------------
-----------------------------------------------------------------------------------------------------
-------------P-----------------------------------------------------CCCCCC----------------------------
------------------------------------------------------------------XXXXXXXX---------------------------
--------------------------------EC-----------------------C-------------------------------------------
----------------------XXXX------XXX-CC------------E---XXXXX------------------------------------------
---------------XXXXXX----------------------------XX---------C-E--------------------------------------
---------------C---------------------------------XX--------XXXXX-------------------------------------
----BBBBBBBBB------------------------------------XX------------------------X-------------------------
B------------------------XXXXXXXXXXX--XXXXXXXX--BXXXXX---------CCC-----------------------------------
-----------------------------------------------------------C-----E------------E----------------------
E---------------------------------------------------------XXXXXXXXX----------------------------------
--------------------------------------------------------------------------------E--------------------
XXXXXXXXXXXXXX------XXXXXX----------------------XXXX-------------------------XXXXX-XXXXXXXXXXXXXXXXXX
