--------------------------------------------------------------------------------------------------------------------
--------------------------------------------------------------------------------------------------------------------
---------------------------------------------------------------------------------X----------------------------------
--------------------------------------------------------------------------------XX----------------------------------
---------------------------------------------------------------------------------X----------------------------------
--------------------------------------B----------------------------------B-----BBB---------BP-----BBB---------------
--------------------------------------------------------------------------------------------------------------------
--------------------------------------------------------------------------------------------------------------------
--------------------------------------------------------------------------------------------------------------------
-------------------B-BP-----------X----X-----------------------------------------------B----------------------------
----------------------------------XX--XX----------------------------------------------------------------------------
-----------------------------SXX--XX-XXXX--------------------------------------------------SX-----------------------
-----------------------------EEX-CXXXXXXX--------------------------------------------------EX-------C---------------
XXXXXXXXXXXXXXXXXXXXXXXXXXXXXXXXXXXXXXXXXXXXXXXXXXXXXXXXXXXXXXXXXXXXXXXXXXXXXXXX---XXXXXXXXXXXXXXXXXXXXXXXXXXXXXXXXX
