-----------------------------------------------------------------------------------------------------
-----------------------------------------------------------------------------------------------------
BBBBBBBBBBBBBBBBBBBBB--------------------------------------------------------------------------------
BBB--------------------------------------------------------------------------------------------------
BBB--------------------------------------------------------------------------------------------------
BBB----------------------------------------------------B--------------------------XCC----------------
-------------------C------------------------------------------------------------X--------------------
------B----------------------------------------------------------------------------------------------
------B-----------B-----------------------------E-----------------------------------XXX--------------
---XX-B----------------------------------------XX----------------------------------------------------
--XXX------------X--XXX---------E----------E---XX---------------E--------------------------XX--------
-XXXX----------XXX--XXX--------XX--------------XX--------B--------X------------------------XX--------
XXXXX------XXXXXXXE-XX---------XX---E----------XX--E-----b-------XX--------X---------------XX-----E--
XXXXXXXXXXXXXXXXXXXXX---XXXXXXXXXXXXXXXXXXXXXXXXXXXXXXXXXXXXX-XXXXXXXXXXXXXXXXX-----------XXXXXXXXXXX
