---------------------------------------------------------------------------------------------------------------------
---------------------------------------------------------------------------------------------------------------------
---------------------------------------------------------------------------------------------------------------------
---------------------------------------------------------------------------------------------------------------------
---------------------------------------------------------------------------------------------------------------------
--------------------------C---------------------------------CC-C-C----------------------C-C-C-C----C-----------------
-------C-------------------CCC-----------C---CC-----------------C-C-------------------C--C-------C-------------------
-----------C----C-------------C----CC-CC--C-C--C--CC-------C--C-------C--CC-C-----C----------C-C--C------------------
--------------------CC-C-CBBPB-CC----------C----C---C--C-C------BB--C-----------C--CCCPBBBBBB------------------------
------P-BB--CCC--C----C----------CC--C-----------B---CC-C---------B-P------C-C---C-----------------------------------
----------B-B-----------C-----P-P-B---------------BBBPBB----------------------C--------------------------------------
-----------------------------E-----------S-----------------SE---E------------------------EE----ESEEE-----------------
------S-------------------XXXX--------XXXXS----ES---------XXXXXXXXE----EE-------------XXXXXXXXXXXXXXXXXXXX-----------
XXXXXXXXXX-EE----S--------XXXXE----SS-XXXXXXXXXXXX---ES---XXXXXXXXXXXXXXXX---E-----EE-XXXXXXXXXXXXXXXXXXXX-----------
XXXXXXXXXXXXXXXXXX--------XXXXXXXXXXXXXXXXXXXXXXXXXXXXXXXXXXXXXXXXXXXXXXXXXXXX----XXXXXXXXXXXXXXXXXXXXXXXX-----------
