---------------------------------------------------------------------------------------------------------------------
---------------------------------------------------------------------------------------------------------------------
---------------------------------------------------------------------------------------------------------------------
---------------------------------------------------------------------------------------------------------------------
---------------------------------------------------------------------------------------------------------------------
--------------------------C-CC---------------------------------C-----------------------------------------------------
-----------------------------------C-----C----C-C----------------------------------------C-C-------------------------
--------C---CC--C-----C-CC-C--------C-------C--C--C----------CC-C-C-CC------------C----C--C--------------------------
-------C-------C--CCC-----B-B-----C--CCCC-C-----BB--C---C-------------C--CC--------C--C------CC-C--------------------
------C--CB-B----C----B--B----CCCC-----------------C-C------------------------------CCBB-BB-B----CC------------------
-------BBB--------------------BBP-----------------BBBBCC------------BP--C--C-C--C--------------C---------------------
-----------------------------E-----------------ES-----P--P-------E----PB---------------------------------------------
-----------SE----------SE-XXXX-----EE----EE---XXXX---------EE-XXXX-----------------------SE--------------------------
------S---XXXX---EE---XXXXXXXXE---XXXXXXXXXXXXXXXX---E----XXXXXXXXS----------------SE-XXXXXXXX----SS--XXXX-----------
XXXXXXXXXXXXXXXXXXXXXXXXXXXXXXXXXXXXXXXXXXXXXXXXXXXXXX----XXXXXXXXXXXX------------XXXXXXXXXXXX----XXXXXXXX-----------
