--------------------------------------------------------------------------------------------------------------------
--------------------------------------------------------------------------------------------------------------------
--------------------------------------------------------------------------------------------------------------------
--------------------------------------------------------------------------------------------------------------------
--------------------------------------------------------------------------------------------------------------------
----------------------------------BBBP---B-----------------------------------------------BBBB-----------------------
--------------------------------------------------------------------------------------------------------------------
--------------------------------------------------------------------------------------------------------------------
--------------------------------------------------------------------------------------------------------------------
-----------------------------BB----B------B---------------------------------------B--------------X-XX---------------
----------------------------------------------------------------------------------------------XX---XX---------------
---------------------------------------------------------------------------------------------XXX---XX---------------
------------------------C-CC-----------CCC--------------------------------------------------XXXX--XXX---------------
XXXXXXXXXXXXXXXXXXXXXXXXXXXXXXXXXXXXXXXXXXXXXXXXXXXXXXXXXXXXXXXXXXXXXXXXXXXXX--XXXXXXXXXXXXXXXXX-XXXXXXXXXXXXXXXXXXX
