-----------------------------------------------------------------------------------------------------
-----------------------------------------------------------------------------------------------------
BBBBBBBBBBBBBBBBBBB----------------------------------------------------------------------------------
B---------------------------------------------------------C------------------------------------------
B-----------------------------------------------E----E-E---------------------------------------------
B---------------------------------BBBBBBBBBBBBBBBBBBBBBBBBB---------------------------------------C--
B-----------------------------------------------------------------------X---------CCC----------------
B----------------------------------------------------------------------------------------------------
B------------------------------E---------------------------------------------------------------------
B---E------XXXXX----X----E----XX-------E----------BBBBBBBB------BBB------------B----------------XX-XX
---XX-----EXXXXXXXXXX-XXXX------------------E-E------------------------------------------------------
---XX---EXXXXXXXXXXXXXXXXX---------------------------------------------------------------------------
E--XX---XXXXXXXXXXXXXXXXXX------------------------E-------E--E---------------------------------C-----
XXXXXXXXXXXXXXXXXXXXXXX-XXXXXXXXXXXXXXXXXXXXXXXXXXXXXXXXXXXXXXXXXXXXXXX----XXXXXXXXXXXXXXXXX---X-----
