---------------------------------------------------------------------------------------------------------------------
---------------------------------------------------------------------------------------------------------------------
---------------------------------------------------------------------------------------------------------------------
---------------------------------------------------------------------------------------------------------------------
---------------------------------------------------------------------------------------------------------------------
-----------C---------------------------------------C-C------------------------C-C------------------------------------
----------C-C--------------C----------------------C----------------------------------------------C-------------------
----------------------CCC---------C-C-C-------C-----C---------------------------------------C------------------------
----------BB-B-C----------C----C--------CC-C---C-CB-B---C-C-------C---CC----C--------CCC--C--------------------------
------C-C-------C--------C--BB--------------CC---B----C--------------C-----C------CC----C--C------C------------------
--------------C---CCC------------C--------C-----------P----C--------C---CCC--C--------PB--BBB------------------------
-------B---SE------------------P---------------------E----------BBB--B--BB----E--------------------------------------
XXXXXX----XXXX---------------E-----------E-----SE-XXXX------------------------XXXX-------------SES-------------------
XXXXXX----XXXX---------EE-XXXX-----SE-XXXX----XXXXXXXXE-----------------------XXXX-ES----EE---XXXXES-----------------
XXXXXX----XXXX--------XXXXXXXX----XXXXXXXX----XXXXXXXXXXXX--------------------XXXXXXXXXXXXXXXXXXXXXXXX---------------
