--------------------------------------------------------------------------------------------------------------------
-----------------------X--------------------------------------------------------------------------------------------
----------------------XXX-------------------------------------------------------------------------------------------
---------------------XXXX-------------------------------------------------------------------------------------------
---------------------XXXX-------------------------------------------------------------------------------------------
---------------------XXXXXXX---BB----------------------------------------BBB-BBBBBP-------------P-------------------
--------------------------------------------------------------------------------------------------------------------
--------------------------------------------------------------------------------------------------------------------
--------------------------------------------------------------------------------------------------------------------
--------------------------------------------------------------------------------------------X--X--------------------
--------------------------------------------------------------------------------------------X--XX-------------------
--------------------------------SXX----------------------------------------------------SXX-XXXXXX-------------------
----------------------------C-C-EEX-------C----------------------------------------C---EEX-XXXXXXX------------------
XXXXXXXXXXXXXXXXXXXXXX-----XXXXXXXXXXXXXXXXXXXXXXXXXXXXXXXXXXXXXXXXXXXXXXXXXXXX---XXXXXXXXXXXXXXXXXXXXXXXXXXXXXXXXXX
