--------------------------------------------------------------------------------------------------------------------
--------------------------------------------------------------------------------------------------------------------
----------------------XXX-------------------------------------------------------------------------------------------
---------------------XXXXX------------------------------------------------------------------------------------------
---------------------XXXX-------------------------------------------------------------------------------------------
---------------BX----XXXXXXX---BBBP------------------------------------------B--------------------------------------
--------------------------------------------------------------------------------------------------------------------
--------------------------------------------------------------------------------------------------------------------
--------------------------------------------------------------------------------------------------------------------
--------------------------------------------------------------------------PB------BB----------XXX-------------------
-------------------------------------------------------------------------------------------XXXXXX---X---------------
-------------------------------------------------------------------------------------------XXXXXX--XX---------------
-------------------------------------------------------------------------------C----------XXXXXXXXXXX---------------
XXXXXXXXXXXXXXX---XXX---------XXXXXXXXXXXXXXXXXXXXXXXXXXXXXXXXXXXXXXXXXXXXXX---XXX---XX--XXXXXXXXXXXXXXXXXXXXXXXXXXX
