-----------------------------------------------------------------------------------------------------
-----------------------------------------------------------------------------------------------------
-----------------------------------------------------------------------------------------------------
-----------------------------------------------------------------------------------------------------
-----------------------------------------------------------------------------------------------------
B-----------E--E---BBBBBBB-----------E---------------------------------------------------------------
-----------XX-XX-------------------XXXXX-------------------------------------------------------------
-----------XX-XX-------------------------------------------------------------------------------------
-----------XX-XX-------------------------------------------------------------------------------------
P----------XXBXXX---E--E----------------------------------------B------------------------------------
-------------------XX-XX-----------------------------------------------------------------------------
-----XX------------XX-XX---X-------------------------------------------------------------------------
-----XX----E-------XX-XX---X-------------------------EEEE----------------------EE--------XX----------
XXXXXXXXXXXXXXXXXXXXXXXXX-XX--XXXX-----XXXXXXXXXXXXXXXXXXXXXXXXXXXXXXXXXXXXXXXXXXXXXXXXXXXXXXXXXXXXXX
