---------------------------------------------------------------------------------------------------------------------
---------------------------------------------------------------------------------------------------------------------
---------------------------------------------------------------------------------------------------------------------
---------------------------------------------------------------------------------------------------------------------
---------------------------------------------------------------------------------------------------------------------
---------------C-----------------------------------------------------------------------------------------------------
------C-------C-----------C-C------------------C-CC-----------------------C----C------C------------------------------
-------CCC------CC-C-C--------------------CC--C------C---------------------C-------CC--CCC------C--C-----------------
------------------------C-BBBB---CCC--------CC--C--CC-----------C---C-C-CC--------C----------CCC---------------------
---------B--------C-C--C-C----------C--CC---------BBP-C-----CCC------C-C--------------BPBB--C----CC------------------
----------BB------------BP----BPBB-------C--------------CC------BPCC--PBB-----------P-----CC-------------------------
-----------------S-----------E-----BP-P---------------------------BPBB-----------------------------------------------
------S-------XXXX--------XXXX------------E----EE----S-----------------------SE----------S------------XXXX-----------
XXXXXXXXXX-SE-XXXXE----SE-XXXXS-----------XXXXXXXXXXXX-----EE----E-----SE-XXXXXXXX-EE-XXXX-----E-SSS--XXXX-----------
XXXXXXXXXXXXXXXXXXXXXXXXXXXXXXXXXX--------XXXXXXXXXXXX----XXXXXXXX----XXXXXXXXXXXXXXXXXXXX----XXXXXXXXXXXX-----------
