--------------------------------------------------------------------------------------------------------------------
--------------------------------------------------------------------------------------------------------------------
--------------------------------------------------------------------------------------------------------------------
--------------------------------------------------------------------------------------------------------------------
--------------------------------------------------------------------------------------------------------------------
----------------------------------BBBBBBBBB-----------------------------------------------BB------------------------
--------------------------------------------------------------------------------------------------------------------
--------------------------------------------------------------------------------------------------------------------
--------------------------------------------------------------------------------------------------------------------
----------------BB--B--P-----BB----B------B--------------------------------------------B--------XX-XX---------------
----------------------------------------------------------------------------------------------XX---XX---------------
------------------------------------------------------------------------------------------E---XX---XX---------------
----------------C-------------C--------C-C--------------------------------------------C---E--XXX--XXX---------------
XXXXXXXXXXXXXXXXXXXXXXXXXXXXXXXXXXXXXXXXXXXXXXXXXXXXXXXXXXXXXXXXXXXXXXXXXXXXXXXXXXXXXXXXXXXXXXXXXXXXXXXXXXXXXXXXXXXX
