--------------------------------------------------------------------------------------------------------------------
--------------------------------------------------------------------------------------------------------------------
--------------------------------------------------------------------------------------------------------------------
--------------------------------------------------------------------------------------------------------------------
--------------------------------------------------------------------------------------------------------------------
----------------BBBBBPBBPB----------------------------------------------------------------B---B---------------------
--------------------------------------------------------------------------------------------------------------------
-----------------C--------------------------------------------------------------------------------------------------
--------------------------------------------------------------------------------------------------------------------
----------------BB------------SXX---------------------------------------------P-----------------XX------------------
------------------------------EEX---------------------------------------------------------------XX------------------
------------------------------EEX------X----------------------------------------------------X--XXXX-----------------
-----------------------C-------EX-----XXC-------------------------------------C---------E---XXXXXXX-----------------
XXXXXXXXXXXXXXXXXXXXXXXXXXXXXXXXXXXXXXXXXXXXXXXXXXXXXXXXXXXXXXXXXXXXXXXXXXXXXXXXXXXXXXXXXXXXXXXXXXXXXXXXXXXXXXXXXXXX
