-----------------------------------------------------------------------------------------------------
-----------------------------------------------------------------------------------------------------
BBBBBBBBBBBBBBBBBBBBBBPBBBBBBBBBBBBBBBBBBBBBBBBBBBBBBBBBB--------------------------------------------
-----------------------------------------------------------------------------------------------------
-----------------------------------------------------------------------------------------------------
----E-----BBB-CCCCCCCCC-----------------------------------------------------------------------------P
---XX-----------------------------------C------------------------------------------------------------
---XX---------BBBBBBBBB------------------------------------------------------------------------------
---XX---------BBBBBBBBB----------------B-------------------X--E--E--------------------B--------------
---XX-----BBB---------------X------XXX----XXX---E---------XX-XX-XX--------------BBB--E--EBB----------
-E-XX----------------------XX---X-XXXXX--XXXX--XX------XXXXX-XX-XX-------------------E-------E-------
XX-XX---------------------XXX-XXXXXXXXX--XXXX--XX-----XXXXXX-XX-XX---XX------------------------------
XX-XX--E------------------XXX-XXXXXXXXXE-XXXX--XX-----XXXXXX-XX-XX---XX-E----------------------------
XXXXXXXXXXXXXXXXXXXXXXXXXXXXXXXXXXXXXXXXXXXXXXXXXXXXXXXXXXXXXXXXXXXXXXXXXXXXXXXXXXXXXXXXXXXXXXXXXXXXX
