-----------------------------------------------------------------------------------------------------
-----------------------------------------------------------------------------------------------------
-----------------------------------------------------------------------------------------------------
-----------------------------------------------------------------------------------------------------
---E-------------------------------------------------------------------------------------------------
---E---------------------BBB------BB-----------------------BBB---------------------------------------
-----------------------------------------------------------------------------------------------------
-------CC-------C------------------------------------------------------------------------------------
-------------------------------------------------------------------C------E------E-------------------
X--------------B---------BBB-----BPB-----------------------PBB-----------XX-----XX-----------X-------
X--------------------E----------------------------E----------------------XX-----XX-----------X---X---
X------------------------------------------------------------------------XX-----XX-----------XX-XX---
-------------------------------------E--E--------------EE-------------E--XX--E--XX------E----XXXXX---
--------XXXXXXXXXXXXXXXXXXXXX-XXXXXXXXXXXXXXXXXXXXXXXXXXXXXXXXXXXX---XXXXXXXXXXXXXXXXXXXXXXXXXXXXXXXX
