-----------------------------------------------------------------------------------------------------
-----------------------------------------------------------------------------------------------------
-----------------------------------------------------------------------------------------------------
-----------------------------------------------B-----------------------------------------------------
EC------------------------------------E--------------------------------------------------------------
XXX--------B-----------------C----PBBBBBBB----------------------------------------------------X-BB---
-------------------C--------------------------X------------------------------------------------------
-----------------------------------------------------------------------------------------------------
----------------------------XXX----------------------------------------------------------------------
XXXXX--------XXXXX------------------E----BB------------BB---E-B--------------------------------------
-----------------------------------XX----------------------XX----------------------------------------
-------X----------------C----------XX----------------------XX-----------B-----B----------------------
------XXX---------XXXXXXXXXX-------XX----EE----------------XX-----------b-----b----------------------
----XXXXXXXXX------------------XXXXXXXXXXXXXX----XXXXXXXXXXXXXXXXXXXXXXXXXXXXXXXXXXXXXXXXXXX---XXXXXX
