-----------------------------------------------------------------------------------------------------
-----------------------------------------------------------------------------------------------------
-----------------------------------------------------------------------------------------------------
-----------------------------------------------------------------------------------------------------
-----------------------------------------------------------------------------------------------------
---------------XXXX-------------------------------C--------------------------------------------------
--------------XXXXX-------------------------------XXXXXX----------CCCCCCCCC--------------------------
----------XXXXXXXXX----------------------------------------------------------------------------------
---------XXXXXXXXXX----------------------------------------------------------------------------------
---------XXXXXXXXXX----------------------------------------------------------------------------------
XXXXXXXXXXXXXXXXXXX----------E-----------------------------------------------------------------------
XXXXXXXXXXXXXXXXXXX---------XX---------------X-------------------------------------------------------
---------XXXXXXXXXX---E--E--XX-----EE-------XX-------------E---------------------------EEE-----------
XXXXXXXXXXXXXXXXXXXXXXXXXXXXXXXXXXXXXXXXXXXXXXXXXX-----XXXXXXXXXXXXXXXXXXXXXXXXXXXXXXXXXXXXXXXXXXXXXX
