-----------------------------------------------------------------------------------------------------
-----------------------------------------------------------------------------------------------------
--------C------------------------------BBBBBBBBBBBBBBBBBBBBBBBBBBBBBBBBBBBBBBBBBPBBBBBBBBBBBBBBBBBBBB
----------------------------------------------BBB----------------------------------------------------
----------------------------------------------BBB----------------------------------------------------
----CC---------B-----B---------------------------------------------------CCCCCCCC--------------------
-----------------------------------------------------------------------------------------------------
-------------------------------------------------------------------------BBBBBBBB--------------------
BB---XXXXX-----B-------------------------------E-------------------B-----BBBBBBBB--------------------
------------XX---BBBPBBB-------X--------------BBB-----------------------------------E----------------
------------------------------XX-------------EE------------------------------------XX-------E--------
-----------------------------XXX---------------------------------------------------XX------XX--------
-----------C--------E-------XXXX----E----------------------------------------------XX------XX--------
XXX--------X----XXXXXXXXXXXXXXXXXXXXXXXXXXXXXXXXX----XX----X--XXXXXXXX-XXXXXXXXXXXXXXXXXXXXXXXXXXXXXX
