---------------------------------------------------------------------------------------------------------------------
---------------------------------------------------------------------------------------------------------------------
---------------------------------------------------------------------------------------------------------------------
---------------------------------------------------------------------------------------------------------------------
---------------------------------------------------------------------------------------------------------------------
----------------C------------------------C---------------------------------------------------------------------------
----------C---C-----C------C------C---------------------------CC------------------C--C--C---------C------------------
------------------C-------C-------------C----------C-C--------------------C-----------C---------C--------------------
------------CC-B------C-------CC---C-C-------CC-------C-C--CC---C--C----C--CC-C-CC--C--C---CC------------------------
---------CB-BB---------C-CB---------------C-C---------------------C-C-CC-C----------------C--CCC---------------------
------CCC------------------------C----------------BB-----------------CB-PBBB-----------------------------------------
-------PBB-------EE-----------BP---------E---BBBBB----------------BB-B---------------------BB-----S------------------
-----------ES-XXXXXXXX-------E-----EE-XXXX------------E----EE----E-----------------S-E---S--------XXXXXXXX-----------
XXXXXX----XXXXXXXXXXXX----XXXX----XXXXXXXX-----------EXXXXXXXXXXXX-----SE----E----XXXXXXXX-----S--XXXXXXXX-----------
XXXXXX----XXXXXXXXXXXX----XXXX----XXXXXXXX--------XXXXXXXXXXXXXXXX----XXXXXXXX----XXXXXXXX----XXXXXXXXXXXX-----------
