---------------------------------------------------------------------------------------------------------------------
---------------------------------------------------------------------------------------------------------------------
---------------------------------------------------------------------------------------------------------------------
---------------------------------------------------------------------------------------------------------------------
---------------------------------------------------------------------------------------------------------------------
-------------------------------------------------C------------------C-----------C------------------------------------
------------------C---C-----------------CC----C-----------C----C-CCC---------------C------C--------C-----------------
-------------------C-C---C------CC---------CC---C-------C---CCC------C------C-------CCC-C--C-C-----------------------
----------C----C-------CC-----C----C-C-C--C--CBPBB---------------BBBPP-CC--C------C----C--B-----C--------------------
--------C----CC----------BC----C------------------BBBBB---------------C------------BPP-----------C-------------------
------CC-C----B--------------C---BC--------------------------------------C------------B-BB---------------------------
---------BB-BB------------B-BP-----------------EE----------SS----ES-----------E-----------E--------------------------
------------------E----EE----------------S----XXXX---SE---XXXXXXXXXXXX-------SXXXX-EE-----XXXX----XXXXXXXX-----------
-----------------SXXXXXXXX----S-------XXXXE---XXXXXXXXXXXXXXXXXXXXXXXX----XXXXXXXXXXXX---EXXXX-E--XXXXXXXX-----------
XXXXXX--------XXXXXXXXXXXX----XXXX----XXXXXXXXXXXXXXXXXXXXXXXXXXXXXXXX----XXXXXXXXXXXXXXXXXXXXXXXXXXXXXXXX-----------
