-----------------------------------------------------------------------------------------------------
-----------------------------------------------------------------------------------------------------
-----CC-------------BBBBBBBB-------------------------------------------------------------------------
----XXXX---------------------------------------------------------------------------------------------
-----------------------------------------------------------------------------------------------------
-------------------B-------------------------------------------------------------E------------BBB----
E---------------------------------------------------E---------------------------XX-------------------
XX------------------------------------------------------------------------------XX------------B------
---------------------------------------------------------------------C----------XX--------BBBB-B-----
-CCC---------------B------------E--------------------------B-----------------EBBXXX-------------B----
---E-----------------------B--EXX----------------------------XX---E-------E--------------------------
XXXXX----------------------B-XXXX----------------------------XX--XX------XX--------------------------
------------------E--E-----B-XXXX------------E---------------XX--XX------XX--------------------------
----------XXXXXXXXXXXXX----XXXXXXXXXXXX-XXXXXXXXXXX-------XXXXXXXXXXXXXXXXXXXXXXXXXXXXX-XXXXXXXXXXXXX
