---------------------------------------------------------------------------------------------------------------------
---------------------------------------------------------------------------------------------------------------------
---------------------------------------------------------------------------------------------------------------------
---------------------------------------------------------------------------------------------------------------------
---------------------------------------------------------------------------------------------------------------------
------CC---------------C-----------------C----------C----------------------------------------------------------------
---------------------C--------CCCCCC--C-C------------C----------C--------C----------------C--------------------------
------------------C------CC---------CC------------CC-----------C---------------C-C-CC-------CC-----C-----------------
-------BBB---C--C-----------C--B-P---------C--C-C-BBB-----CC-CC--CCC---CC-CCC---------C------------------------------
-----------------C---------------------------C---------C------------BPB-B-B---------------PPBPC--C-------------------
-----------CC--C--------------------------C----C-C------C---C--------------------------C-------CC--B-----------------
------E----PBPB---E----EE-----E----SE----EB--BBPBP---EB-----------------------E----EE----B----BB---------------------
XXXXXXXXXX--------XXXXXXXX---EXXXXXXXXXXXX--------XXXX-----------SS----SS---E-XXXXXXXX----S--------------------------
XXXXXXXXXX--------XXXXXXXXXXXXXXXXXXXXXXXX--------XXXX--------XXXXXXXXXXXXXXXXXXXXXXXX----XXXX----EE-----------------
XXXXXXXXXX--------XXXXXXXXXXXXXXXXXXXXXXXX--------XXXX--------XXXXXXXXXXXXXXXXXXXXXXXX----XXXX----XXXXXXXX-----------
