--------------------------------------------------------------------------------------------------------------------
--------------------------------------------------------------------------------------------------------------------
--------------------------------------------------------------------------------------------------------------------
--------------------------------------------------------------------------------------------------------------------
--------------------------------------------------------------------------------------------------------------------
--------------------------------------------------------------------------BBBBBBBBP---------------------------------
--------------------------------------------------------------------------------------------------------------------
--------------------------------------------------------------------------------------------------------------------
--------------------------------------------------------------------------------------------------------------------
------------------------B---------X--X------------------------------------------------------X--X--------------------
---------------------------------XX--------------------------------------------------------XXX-X----X---------------
------------------------------SXXXX----------------------------------------------------SXX-XXXXXX--XX---------------
-------------------------C----EXXXX--X-------------------------------------------------EXXXXXX-X--XXX---------------
XXXXXXXXXXXXXXX---------------EXXXXXXXXXXXXXXXXXXXXXXXXXXXXXXXXXXXXXXXXXXXXXXXX---XXXXXXXXXXXXXXXXXXXXXXXXXXXXXXXXXX
