--------------------------------------------------------------------------------------------------------------------
--------------------------------------------------------------------------------------------------------------------
--------------------------------------------------------------------------------------------------------------------
--------------------------------------------------------------------------------------------------------------------
--------------------------------------------------------------------------------------------------------------------
-------------------BBBBBP-------------------------------------------------BBBBBBB-----------------------------------
--------------------------------------------------------------------------------------------------------------------
--------------------------------------------------------------------------------------------------------------------
--------------------------------------------------------------------------------------------------------------------
----------------------------------X-XX--X------------------------------------B----------------B---------------------
----------------------------------XXXXXXXX--------------------------------------------------------------------------
------------------------------SXXXXXXXXXXX----------------------------------------------SXX-------SXX---------------
------------------------------E-XXXX-XXXXX-----------------------------------------C-C--EEXC------EEX---------------
XXXXXXXXXXXXXXXXXXXXXXXXXXXXXXXXXXXXXXXXXXXXXXXXXXXXXXXXXXXXXXXXXXXXXXXXXXXXXXXXXXXXXXXXXXXXXXXXXXXXXXXXXXXXXXXXXXXX
