-----------------------------------------------------------------------------------------------------
-----------------------------------------------------------------------------------------------------
-----------------------------------------------------------------------------------------------------
-----------------------------------------------E-E---------------------------------------------------
--------------------------------------------XXXXXXXX-------------------------------------------------
-----------------------------------------------------------------------------------------------------
--------C--CC--------------------------------------------------------CCCCCCCCC-----------------------
-----------------------------------------------------------------------------------------------------
------------------------------------------XX----------------------------------------B----------------
------------XXXXX----B-------------------------------------X-----------------------------------------
-XX---------------------E---------------------------------XX-----------------------------------------
XXX--------------------XX-----B----XX--------------------XXX-----------------------------------------
XX----XXXXXX-----X-----XX-----b----XX-----C-----------E-XXXX------------------------------------E----
-------------------XXXXXXXXXXXXXXXXXXXXXXXX----------XXXXXXXXXXXXXXXXXXXXXXXXXXXXXXXXXXXXX--XXXXXXXXX
