---------------------------------------------------------------------------------------------------------------------
---------------------------------------------------------------------------------------------------------------------
---------------------------------------------------------------------------------------------------------------------
---------------------------------------------------------------------------------------------------------------------
---------------------------------------------------------------------------------------------------------------------
------------C-----------------------C-------------------------------------------------------------C------------------
------------------------C----------C------CC-----------C-------C--C--------------------------------C-----------------
----------CC-----C-----C-C-C------C---------------------CC----C-C--CC-----------C----------C-C-----------------------
-------------B--C-C-------C---C----B--C-----CCCCC--------------------------C--C--C----C---B----CCC-------------------
---------------C---C----BP--C----------C-C--B------C--PB--CC-C----BB-B--CCC-CC----CC----C----------------------------
------C-C-----------------BBBB--CC------------------C-----------------CC-------------C---C---------------------------
-----------ES-----------------BBBB-EE---------BBBBBBB------------E----PB-----------PBBBP-BS-------ES-----------------
XXXXXX----XXXX---------SE---------XXXX----S-----------S-------XXXXE-----------S-----------XXXX-E-EXXXXXXXX-----------
XXXXXX----XXXX---S----XXXX---E----XXXX----XXXX--------XXXX-SE-XXXXXXXX-------EXXXX--------XXXXXXXXXXXXXXXX-----------
XXXXXX----XXXXXXXX----XXXXXXXX----XXXX----XXXX--------XXXXXXXXXXXXXXXX----XXXXXXXX--------XXXXXXXXXXXXXXXX-----------
