-----------------------------------------------------------------------------------------------------
-----------------------------------------------------------------------------------------------------
-------------------------------------------------------------------------------BBBBBB----------------
-------------------------------------------------------------------------E--E------------------------
------------------------------------------XXXX-------------------------XXXXXXX-----------------------
XX-----CC-----CCC-------------------CCCC-------XX--CC----------------C------------------E---XXXX-----
------------XXX-------------------XXX-------------------------C----------------------------XXXXX-----
------------------------------------------------------------------------------------------XXXXXX-----
-----X----------XX-------X-------------XXX-------X--------------XXXXXXX-----------------EXXXXXXX-----
--X------X-------------------------------------------XXX-------------------------------XXXXXXXXX-----
----------------------------------------------------------------------------------BBB--XXXXXXXXX-----
----------------------------------------------------------------------------------BBB--XXXXXXXXX-----
---XX-----------------------XXXXX-----------------------XXXXXXXX------------------BBB--XXXXXXXXX----E
----------------------------------------------------------------------------------XXXXXXXXXXXXXXXXXXX
