-----------------------------------------------------------------------------------------------------
-----------------------------------------------------------------------------------------------------
-----------------------------------------------------------------------------------------------------
-----------------------------------------------------------------------------------------------------
-----------------------------------------------------------------------------------------------------
-------------------B-----------------------------------------------------------------------B-------BB
-E---------------------------------------------------------------------------------------------------
XX----E----------------------------------------------------------------------------------------------
XX---XX-------------------E--------------E--------------------------------------------BBBBB----------
XX---XX---------BBBB-----XX--------E----XX-----------------------------------------------------------
XX---XX---------------------------XX----XX-----------------------------------------------------------
XX---XX---------------------------XX----XX-----------------------------------------------------------
XX---XX----------------------EE---XX----XX---------EEE---EE--------E-------EE------------------------
XXXX-XXXXXXXXXXXXXXXXXXXXXXXXXXXXXXXXXXXXXXXXXXXXXXXXXXXXXXXXXXXXXXXX-XXXXXXXXXX-XXXXXXXXXXXXXXXXXXXX
