---------------------------------------------------------------------------------------------------------------------
---------------------------------------------------------------------------------------------------------------------
---------------------------------------------------------------------------------------------------------------------
---------------------------------------------------------------------------------------------------------------------
---------------------------------------------------------------------------------------------------------------------
---------------------------------------------------------------------------------CC--C-------------------------------
-------C-C----C--C------------------------------------CC-C--------------------------C-----C--------------------------
------C-C------C-----C------C-----C-C-----C-C--------------C----------CC--CC--CC---C--CC---C-----C-------------------
----------------C---C-----C---C-CC-----------------C----C-C--C-C--C---------C-------------------C--------------------
------------C--------------C-C-----C-C-----C--C--CC-C-PBB---C---C--------C---C-----------P-BP--C---------------------
----------B-B----------C----BBB-BBPB-B--------BBPB------------------C--B---------------------------------------------
----------------------------------------E---------BBPB-------------B-B--------E----SE--------------------------------
------E----------E--------------------XXXX------------S-----------------------XXXXXXXX---EE--------------------------
XXXXXXXXXX-SS-XXXXS----------SS----SE-XXXXS----ES-----XXXX-EE----E-----ES----SXXXXXXXXXXXXXXXX-SEE-------------------
XXXXXXXXXXXXXXXXXXXXXX----XXXXXXXXXXXXXXXXXXXXXXXX----XXXXXXXXXXXX----XXXXXXXXXXXXXXXXXXXXXXXXXXXX-------------------
