---------------------------------------------------------------------------------------------------------------------
---------------------------------------------------------------------------------------------------------------------
---------------------------------------------------------------------------------------------------------------------
---------------------------------------------------------------------------------------------------------------------
---------------------------------------------------------------------------------------------------------------------
--------------------------CC-C------C-----CC----------------------------------------C--CC-----C--C-------------------
------------CC-----------------------C-----------------C-C-----------------CC-----CC-C----------C--------------------
-------C-----------------C--C-----C---------CC--------C-C-C------CCC-CC------C-----------C---------------------------
------C-C------------C-C--BP-B----------C---B-----------------CCC---C--C---------------BBB---C-----------------------
----------BB------C-C-----------C------C-------------C-------C----BPB---------CC-C--------C-------C------------------
------B--B------CC------------CC---------C-----C--B-B-----------------BPBB-----------------C-------------------------
-----------------------------SBB-B-EE-----E----BBB----E----------------------------SE----EB----S-S-------------------
-----------EE-------------XXXX----XXXX----XXXX--------XXXX--------E----------E----XXXXXXXX----XXXX-------------------
------E---XXXX---------ES-XXXX----XXXX----XXXX-------EXXXX-ES----SXXXX-EE-XXXX----XXXXXXXX----XXXX----XXXX-----------
XXXXXXXXXXXXXX--------XXXXXXXX----XXXX----XXXX----XXXXXXXXXXXXXXXXXXXXXXXXXXXX----XXXXXXXX----XXXX----XXXX-----------
