---------------------------------------------------------------------------------------------------------------------
---------------------------------------------------------------------------------------------------------------------
---------------------------------------------------------------------------------------------------------------------
---------------------------------------------------------------------------------------------------------------------
---------------------------------------------------------------------------------------------------------------------
----------CC----C---------------------------------------C------------C-----------------C-----------------------------
--------------------------------C----C----------------CC---------CC-----------C-CC------C-----C----------------------
------C-----C--C-CCC-C---C----C--C-CC------C----C--------C----C-C--C------C-------C-C-------C--C--C------------------
-------BBBB------------C----------B------CC-C--------C------C----B--PPCC---------------BBPC--C--CC-------------------
------------------------C-C----BBP------C-----CC-C-C--------------------C--C-C-----C-C-------------------------------
----------------------P-BP---C--------C------BB-BBBBB-----CC-C--------BBBB-----------------B-------------------------
------S----ES----E--------B-PB-----S-E-----------------S---------EE----------------------E---------------------------
XXXXXXXXXXXXXXXXXXE-----------E---XXXX----------------XXXX----XXXXXXXX--------E-------XXXX-----SEE-------------------
XXXXXXXXXXXXXXXXXXXXXX-EE-----XXXXXXXX----E----EE----SXXXX----XXXXXXXX-EE----EXXXX-EE-XXXXE---XXXXE------------------
XXXXXXXXXXXXXXXXXXXXXXXXXX----XXXXXXXX----XXXXXXXXXXXXXXXX----XXXXXXXXXXXXXXXXXXXXXXXXXXXXXXXXXXXXXXXX---------------
