-----------------------------------------------------------------------------------------------------
-----------------------------------------------------------------------------------------------------
-----------------------------------------------------------------------------------------------------
-----------------------------------------------------------------------------------------------------
-----------------------------------------------------------------------------------------------------
---BBBB------------------------------------------XXXX-------------------------------------BB---------
-----------CCCCCC------------------------------------------------------------------------------------
B-------------------------------------X--------------------------------------------------------------
b-----------------------------------E------------------BB---------------------------------------CCCC-
XBBBB-----------------B------------XX----------------------------------------------E------BB---------
-----------------------------------XX----------------------E----------------------XX-----------------
-----------------------------------XX---------------------XX----------------------XX-----------------
---------------------EE-E---E------XX---------------------XX----------------------XX-----------------
XXXXXX---XXXXXXXXXXXXXXXXXXXXXXXXX-XX-XXXX-----------XXXXXXXXXXXXXXXXXXXXXXXXXXXXXXXXXXXXXXXXXX------
