---------------------------------------------------------------------------------------------------------------------
---------------------------------------------------------------------------------------------------------------------
---------------------------------------------------------------------------------------------------------------------
---------------------------------------------------------------------------------------------------------------------
---------------------------------------------------------------------------------------------------------------------
---------------------------------C----C----------C--------------C---CC----C-C---------CC-----------------------------
------C--C------CCCC-C----------C-------CCC--CC----------------C-CCC----------------C---C----------------------------
--------C---C--C---------------------------CC--CC-------C--C--C--------C---C-C----CC-----------C---------------------
-------C---C-C-B----C---------PB---C----------P-BB--------C-CC---BPBBBC--C-----------CBBB-C------CCC-----------------
-------BBPC--------B--CC--C---------C-------------------------------------------C-BBB-------C------------------------
----------BBBB----------CC-C------C--C--------------------------------BB-------C-C-----------------------------------
-----------------S---------BBBE----------S-----EE-PB-------------EE----------E-----------E---------------------------
------S-------XXXXE-----------XXXX----XXXXE---XXXX---------EE-XXXXXXXX----XXXX-----EE-XXXX---------------------------
XXXXXXXXXX-SE-XXXXXXXX--------XXXX----XXXXXXXXXXXX----S---XXXXXXXXXXXX-ES-XXXX----XXXXXXXXE----EES-------------------
XXXXXXXXXXXXXXXXXXXXXX--------XXXX----XXXXXXXXXXXX----XXXXXXXXXXXXXXXXXXXXXXXX----XXXXXXXXXXXXXXXX-------------------
