-----------------------------------------------------------------------------------------------------
-----------------------------------------------------------------------------------------------------
-----------------------------------------------------------------------------------------------------
X----------------------------------------------------------------------------------------------------
-----------------------------------------------------XXXXXXX-----------------------------------------
---XXXX-------------------XX----------XXXXXXXX---C-----------XX-------------P------------------------
---XXXX------------------XXX---------------------------------XX--------------------------------------
---XXXX-----------------XXXX---------------------------------XX--------------------------------------
---XXXX----------------XXXXX-------------------XXXXXX--------XX--------------------------------------
---XXXX---------------XXXXXX---------------------------------XX--------------------------------------
---XXXX------------X-XXXXXXX---------------------------------XX---------E----------E-----------------
---XXXX-----------XXXXXXXXXX---------------------------------XX--------------------------------------
---XXXX-----E----XXXXXXXXXXX---------------------------------XX--------------------------E-----------
---XXXXXXXXXXXXXXXXXXXXXXXXXXXXXXXXXXXXXXX-------------------XXXX-----XXXXXXXXXXXXXXXXXXXXXXXXXXXXXXX
