-----------------------------------------------------------------------------------------------------
-----------------------------------------------------------------------------------------------------
-----------------------------------------------------------------------------------------------------
-----------------------------------------------------------------------------------------------------
-----------------------------------------------------------------------------------------------------
------------XXX---------------------------------------------------------B----------------------------
BB---CCCC-------------------CC-----------------------------------------------------------------------
-----------------------------------------------------------------------------------------------------
------------------C----------------------------------E-----------------------------------------------
--------------XX------------------------E-----------XX----------E------BBB------------------------X--
-BB------------------------------------XX-----------XX--------XXX---------------------------------XX-
--------------------X------------------XX-----------XX-X----XXXXX---------------------------------XXX
--------------------------------E------XX-----------XX-X---XXXXXX---------------------------------XXX
XX---XXXXXXXXXX--------XXXXXXXXXXXXXXX-XXXXXXXXXXXXXXXXXXXXXX--XXX---XXXXXXXXXXXXXXXXXXXX--XXXXXXXXXX
