--------------------------------------------------------------------------------------------------------------------
--------------------------------------------------------------------------------------------------------------------
--------------------------------------------------------------------------------------------------------------------
--------------------------------------------------------------------------------------------------------------------
--------------------------------------------------------------------------------------------------------------------
---------------BB-----------------------------------------------------------BBBP--XX------BB------------------------
--------------------------------------------------------------------------------------------------------------------
--------------------------------------------------------------------------------------------------------------------
--------------------------------------------------------------------------------------------------------------------
-------------------------------------X---XX-------------------------------PB--------------------XX------------------
------------------------------------XX---XX----------------------------------------------------XXX------------------
---------------------------------XXXXX---XX-----------------------------------------------XX-XXXXXX-----------------
---------------------------------XXX-X--XXX------------------------------------C----------EXXXXXXXX-B---------------
XXXXXXXXXXXXXXXXXXXX-------------XXXX---XXXXXXXXXXXXXXXXXXXXXXXXXXXXXXXXXXXXXXXXXX--XXXXXXXXXXXXXXXXXXXXXXXXXXXXXXXX
