--------------------------------------------------------------------------------------------------------------------
--------------------------------------------------------------------------------------------------------------------
--------------------------------------------------------------------------------------------------------------------
----------------------------------------------------------------------------------X---------------------------------
--------------------------------------------------------------------------------------------------------------------
------------------BBBP--B----------------------------------------------------------------BBBB-BBBBB-B---------------
--------------------------------------------------------------------------------------------------------------------
----------------------------------------------------------------------------------------C---------------------------
--------------------------------------------------------------------------------------------------------------------
--------------------B--P-------SXX--P-------------------------------------------P-----BPB---------------------------
-------------------------------EEX----------------------------------------------------------------------------------
-------------------------------EEX------SXX-------------------------------------------------------------------------
----------------C-C-C-----CC---EEX------EEX------------------------------------------------------CC-C---------------
XXXXXXXXXXXXXXXXXXXXXXXXXXXXXXXXXXXXXXXXXXXXXXXXXXXXXXXXXXXXXXXXXXXXXXXXXXXXXXXXXXXXXXXXXXXXXXXXXXXXXXXXXXXXXXXXXXXX
