-----------------------------------------------------------------------------------------------------
-----------------------------------------------------------------------------------------------------
--------------------------------B----------------------------------E---------------------------------
--------------------------------B--------------------------------------------------------------------
--------------------------------B--------------------------------------------------------------------
XX--------------------X---------B-----------------------------------------------------------------PB-
----------------------X---------B--------------------------------------------------------------------
---------------------XX---------B--------------------------------------------------------------------
---------------------XX---------B----------------------------C-------------------C-------------------
-----------XXXX-----XXX---------B--BBB--BB---------------E-----------------------------B------------E
--------------------XXX---------B--------------------E--XX--------------------------E--------------XX
------------------B-XXX---------B-------------------XX--XX-------------------------XX--------------XX
------------------b-XXX---------B-----------------E-XX--XX---------XX---------E----XX-----E----E---XX
XXXXXXXXXXX-----XXXXXXXXXXXXXXXXXXXXXXXXXXXXXXXXXXXXXXXXXXXXXXXXXXXXXXXXXXXXXXXXXXXXXXXXXXXXXXXXXXXXX
