-----------------------------------------------------------------------------------------------------
-----------------------------------------------------------------------------------------------------
-----------------------------------------------------------------------BBBBBBBBBBBBBBBBBBBBBBBBBBBBBB
-----------------------------------------------------------------------------------------------------
-------------------------------------------------------------------------------------------E---------
--XX---------------------------------------------------------------------------------------BB--------
-XXX---------------------------------------------------------------------------------------BB--------
EXXX---------------------CC----------------------------------------------------------------BB--------
XXXX----------------------------C-----------------E--C-------------------------------------BB--------
XXXX------E--------------------------------------XX-C--------XXXXXXXXX-------E---E---------BB--------
XXXX-----XX--------------------------------------XX-----XXXX------------B---XX--XX-------------------
XXXX-----XX--------------------------------------XX---------------------B---XX--XX-------------------
XXXX-----XX--------E------------------------EE---XX---------------------B---XX--XX--E---E------------
XXXXXXXXXXX----XXXXXXXX---XXXXXXXXXXXXX-XXXXXXXXXXXXXXXX----------------X-XXXXXXXXXXXXXXXXXXXXXXXXXXX
