-----------------------------------------------------------------------------------------------------
-----------------------------------------------------------------------------------------------------
-----------------------------------------------------------------------------------------------------
-----------------------------------------------------------------------------------------------------
-----------------------------------------------------------------------------------------------------
--------------------------X-----------------------------------------------------------------BBBB-----
C----------------------------------------------------------------------------------------------------
-----------------------------------------------------------------------------------------------------
----------------------------------------C------------------------------------------------------------
----------------------------------------------CCCC-----------------E--B------BBBB--------------------
----------------------------------------------------B-------------XX---------------E---------E-------
----------------------------------------------------b-------------XX------XX----------------XX-------
XX---------XX----E----------EEE-----------------------------------XX------XX----------------XX-------
--------XXXXXXXXXXXXXXX--XXXXXXXXXXXXXXXXXXXXXXXXXXXXXXXXXXXXXXXXXXXXXXXXXXXXXXXXXXXXXXXXXXXXXXXXXXXX
