---------------------------------------------------------------------------------------------------------------------
---------------------------------------------------------------------------------------------------------------------
---------------------------------------------------------------------------------------------------------------------
---------------------------------------------------------------------------------------------------------------------
---------------------------------------------------------------------------------------------------------------------
--------------CCC--------------CC------------------------------------------------------------------------------------
----------CCC-------------C------------------C--------C----------C-----------------------------C-C-------------------
-----------------CC--CC----------CC--------------------C------CCC---------CC-C--C-----------------C------------------
-------------C------C--CCC---CPB---CC-C----CC---C-CCC-------------C-CC---C--------C--------C--C-C--C-----------------
-------C--PP-------C----BBPBBB-----------C----C-------BBB-CC------BBB--CC-----C--C-C-CC-C----C-----------------------
--------PB------------------------------C---------B-PP----------------BBBP-------------PBB---------------------------
-----------------E------------E----------------BBP---------B-----S-----------S------------BBB------------------------
-----------EE-XXXX-----EE----EXXXX-ES-----E-----------E-------XXXXE-------XXXX-----------------EE--E-----------------
------E---XXXXXXXXE---XXXXXXXXXXXXXXXX----XXXX-------EXXXX----XXXXXXXX-EE-XXXXE----EE----E----XXXXXXXX---------------
XXXXXXXXXXXXXXXXXXXXXXXXXXXXXXXXXXXXXX----XXXX----XXXXXXXX----XXXXXXXXXXXXXXXXXXXXXXXXXXXX----XXXXXXXXXXXX-----------
