---------------------------------------------------------------------------------------------------------------------
---------------------------------------------------------------------------------------------------------------------
---------------------------------------------------------------------------------------------------------------------
---------------------------------------------------------------------------------------------------------------------
---------------------------------------------------------------------------------------------------------------------
------------C-----C--------------------------------------C--C---------C--C-C-----------------------------------------
---------------CCC------------------------------------C-C-C--C---------C------C--C-----------------------------------
-------C-----------C-----------------------------------C----------C--C--C-C-CC-C-----------------C-------------------
----------B--------------CC-C-C---C--CC------CC----C-------------C-----PB---------C--CC-----C--C---------------------
------C-C--------------------C-CCC-------C--C--------C--------C-C---C---------------C--C-CCC----C-CC-----------------
------PBPB-------------C---C--PP-P-CC--CC-CC---C--C-C---------------BP---------------B-BB-PPBBBB---------------------
-----------EE----EE---------BP----P-------B--PBBB-B-B-E----SE----------EE----S---------------------------------------
----------XXXXXXXXXXXX--------------------------------XXXXXXXX--------XXXXXXXXE--------------------------------------
------E---XXXXXXXXXXXX--------S-----------------------XXXXXXXX----E---XXXXXXXXXXXXE-S----ES----E-S-E-----------------
XXXXXXXXXXXXXXXXXXXXXX--------XXXX--------------------XXXXXXXX----XXXXXXXXXXXXXXXXXXXXXXXXXXXXXXXXXXXX---------------
