---------------------------------------------------------------------------------------------------------------------
---------------------------------------------------------------------------------------------------------------------
---------------------------------------------------------------------------------------------------------------------
---------------------------------------------------------------------------------------------------------------------
---------------------------------------------------------------------------------------------------------------------
---------------------------------------------------------------------------------------------------------------------
-------------C-------------C----------C-C--------------CC--------------------------C---------------------------------
-----------CC-------CCC------------------------C---CCCC----C-----C-----CCC-------CC----C------CC--CC-----------------
------C----------------C-C--C------C---C-C-CC-----BB-P---------C------C---CC--CCC---BB----C--------------------------
--------C-----C--------B----BP----C-C-----C-------------BB----C-C--CC-BBBB--CC--------C--C---C-----------------------
-------PBP------C--------------CC----------------P-------------------C----------------BPBB-CC------------------------
--------------------------------BP-B-----------------E------------B-------B--------EE--------------------------------
-----------EE----------ES----E-----------E--------XXXXE----SE----------ES-----E---XXXX-------------E-----------------
------E---XXXX----E---XXXXXXXX--------XXXX-----SE-XXXXXXXXXXXX---E----XXXX----XXXXXXXX---E-----SESXXXX---------------
XXXXXXXXXXXXXX----XXXXXXXXXXXX--------XXXX----XXXXXXXXXXXXXXXXXXXX----XXXX----XXXXXXXXXXXX----XXXXXXXXXXXX-----------
