---------------------------------------------------------------------------------------------------------------------
---------------------------------------------------------------------------------------------------------------------
---------------------------------------------------------------------------------------------------------------------
---------------------------------------------------------------------------------------------------------------------
---------------------------------------------------------------------------------------------------------------------
-------------------C------C-----------------------C-------------------------C----------C-----------------------------
--------------------C--C-C-C----------C--C--C-C------C-------------------------C------C-C------C---C-----------------
-------C---C-C----C--C-------C---------CC-CC-C---C--C------------C-C-C----C--C--C--CC------------CC------------------
------------C------------------C---C-----------C--P-PP-C------------C----C------------BPBB---CC----------------------
----------BBBP-----------------------------------B-------CC-CCCCC-BBBB------------C--C-------------------------------
-------B-P-----CCC---------------CC-CC----------------C--------BB------------------BBB-----CC------------------------
--------------B---E----------E-B--BBBB---------------EB---------------BP----S-E----------S-B------EE-----------------
-----------SE-----XXXXS-E-XXXX-----------EE----SS-XXXX------------E-------XXXXXXXX----XXXX-----S-EXXXX---------------
------E---XXXX----XXXXXXXXXXXX--------XXXXXXXXXXXXXXXX-----ES----EXXXX----XXXXXXXX-SE-XXXX----XXXXXXXX---------------
XXXXXXXXXXXXXX----XXXXXXXXXXXX--------XXXXXXXXXXXXXXXX----XXXXXXXXXXXX----XXXXXXXXXXXXXXXX----XXXXXXXX---------------
