--------------------------------------------------------------------------------------------------------------------
--------------------------------------------------------------------------------------------------------------------
--------------------------------------------------------------------------------------------------------------------
--------------------------------------------------------------------------------------------------------------------
--------------------------------------------------------------------------------------------------------------------
------------------BBBP-------------------------------------------------------------------BBB------------------------
--------------------------------------------------------------------------------------------------------------------
--------------------------------------------------------------------------------------------------------------------
--------------------------------------------------------------------------------------------------------------------
----------------BB-------------SXX---B---------------------------------------------------------X---X----------------
-------------------------------EEX-----------------------------------------------------------------XX---------------
-------------------------------EEX--------------------------------------------------------XX---X---XX---------------
------------------------C-CC---EEX------C-C-----------------------------------------------EXXX-----XX---------------
XXXXXXXXXXXXXXXXXXXXXXXXXXXXXXXXXXXXXXXXXXXXXXXXXXXXXXXXXXXXXXXXXXXXXXXXXXXXXXX---------XXXXXXX--XXXXXXXXXXXXXXXXXXX
