-----------------------------------------------------------------------------------------------------
-----------------------------------------------------------------------------------------------------
-----------------------------------------------------------------------------------------------------
-------------C-C-C-----------------------------------------------------------------------------------
------------XXXXXXX----------------------------------------------------------------------------------
-------------------------------------------------------------------------B----BBB-----------BB-------
E----------------------------------------------------------------------------------------------------
X----------------------------------------------------------------------------------------------------
X----------------------------------------------------------------------------------------------------
X--------------------------------------E------------E---------------------------------------BBBBB----
----------B---------------------------XX-----------XX-E--X---------------------E---------------------
----------b---------------------------------------------XX---------B----------XX---------------------
----X-E---B------------E------------------------E------XXX---------b-------E--XX--------EE-----------
XXXXXXXXXXXXXXXXXXXXXXXXXXXXXXXXXXXXXXXXXXXXXXXXXXXXXXXXXXXXXXXXXXXXXXXXX-XXXXXXXXXXXXXXXXXXXXXXXX---
