-----------------------------------------------------------------------------------------------------
-----------------------------------------------------------------------------------------------------
------------------------------------------------------------------------------BBBBBBBBBB--------BBBBB
------------------------------------------------------------------------------------------------BBBBB
------------------------------------------------------------------------------------------------BBBBB
-----------------------------------------------------------------------BBB----------------------BBBBB
--------CCCCCCC---------------------------------------------------------------------------------B----
------------------------------------------------------------------------------------------------B----
-------------------------------------------------------------------------------------------------PCCC
-----------------------------------------------B--------------------------------E---------E------PPBB
B---E---------------------X-----------------------E----------------------------XX------XXXX----------
b--XX--------------------XX----------------------XX----------------------------XX---EXXXXXX----------
---XX--------------------XX----------------------XX-E-E------E-----------------XX---XXXXXXX----------
XXXXXXXXXXXXXXXXXXXXX----XXXXXXXXXXXXXXXXXXXXXXXXXXXXXXXXXXXXXXXXXXXXXX---XXXXXXXXXXXXXX-XXXXXX-XXXXX
