---------------------------------------------------------------------------------------------------------------------
---------------------------------------------------------------------------------------------------------------------
---------------------------------------------------------------------------------------------------------------------
---------------------------------------------------------------------------------------------------------------------
---------------------------------------------------------------------------------------------------------------------
----------------CC------------------------------CC--------C-----------------C---------CCC----------------------------
-------------CCC----------CCCC---------C---------------------------------C-------------------------------------------
----------C-C------------C------------C-----CCCC-----------C--CCC-------C-C--C----C------------C--C------------------
--------C--C--------CC----BP-B-------C---C-------B------CC-----------C-C---------------BBB----C-C--------------------
-----------BP------C---CC------C----C-----CC--------CC--------------C-BB------C-C--C-C-----C-----C-------------------
------C-----------------BB------CC-C--------------BBBBB-----------C-----------------------B-P------------------------
------PBBB-------S-----------EB----------------SS----------EE----SPPBB-------E-----------S---------------------------
-----------EE-XXXX--------XXXX-----------E----XXXX--------XXXXXXXX-----EE-XXXX--------XXXX---------------------------
XXXXXX----XXXXXXXX-----EE-XXXX--------XXXXS---XXXX---EE---XXXXXXXX----XXXXXXXXE----ES-XXXXE----SEE-S-----------------
XXXXXX----XXXXXXXX----XXXXXXXX--------XXXXXXXXXXXXXXXXXXXXXXXXXXXX----XXXXXXXXXXXXXXXXXXXXXXXXXXXXXXXXXXXX-----------
