--------------------------------------------------------------------------------------------------------------------
--------------------------------------------------------------------------------------------------------------------
--------------------------------------------------------------------------------------------------------------------
--------------------------------------------------------------------------------------------------------------------
------------------------------------------C-------------------------------------------------------------------------
------------------------------------BBBBBBB-------------------------------------------------------------------------
--------------------------------------------------------------------------------------------------------------------
------------------------------------C-------------------------------------------------------------------------------
--------------------------------------------------------------------------------------------------------------------
----------------------------------BBB-----B-------------------------------------------------------------------------
--------------------------------------------------------------------------------------------------------------------
-----------------------------SX-------------------------------------------------------------------X-----------------
-------------------------C-C-E-----------C-------------------------------------------------------CC-C---------------
XXXXXXXXXXXXXXXXXXXXXXXXXXXXXXXXXXXXXXXXXXXXXXXXXXXXXXXXXXXXXXXXXXXXXXXXXXXXXXXX-XXXXXXXXXXXXXXXXXXXXXXXXXXXXXXXXXXX
