-----------------------------------------------------------------------------------------------------
-----------------------------------------------------------------------------------------------------
-----------------------------------------------------------------------------------------------------
-----------------------------------------------------------------------------------------------------
------------------E--E-------------------------------------------------------------------------------
-----XXX--XXX---BBBBBBBB-----------P------------------------------------------------------------C-E--
----XXXX--XXX-----------------------------------------------------------------------------------XXXXX
--XXXXXX--XXX----------------------------------------------------------------------------------------
-XXXXXXX--XXX-----------------------------------------------E----------------------------------------
XXXXXXXX--XXX--B-------------------B-----------------------XX----------------------------------------
XXXXXXXX--XXX-----------------------------E--X-------------XX-B--------------------------------------
XXXXXXXX-------------------------------------X-------------XX-b--------------------------------------
XXXXXXXX------EE------------EE---------------X-------------XX-----E-------------------------EE-------
XXXXXXXXXXXXXXXXXXXXXXXXXXXXXXXXXXXXXXXXXX-XXXXXX-XXXXXXXXXXXXXXXXXXXXXXXXXXXXXXXXXXXXXXX-XXXXXX----X
