--------------------------------------------------------------------------------------------------------------------
--------------------------------------------------------------------------------------------------------------------
----------------------XXX-------------------------------------------------------------------------------------------
---------------------XXXX-------------------------------------------------------------------------------------------
---------------------XXXX-------------------------------------------------------------------------------------------
---------------------XXXXXXX----------------------------------------------------------------BBB---------------------
--------------------------------------------------------------------------------------------------------------------
--------------------------------------------------------------------------------------------------------------------
--------------------------------------------------------------------------------------------------------------------
-----------------------------B--SXX-------------------------------------------BBPB-----BB----B-BB---B---------------
--------------------------------EEX---------------------------------------------------------------------------------
--------------------------------EEX---------------------------------------------------------------------------------
----------------------------C-C-EEX--------------------------------------EX-C-C-----CC-----------C-C----------------
XXXXXXXXXXXXXXXXXXX--XX----XXXXXXXXXXXXXXXXXXXXXXXXXXXXXXXXXXXXXXXXXXXXXXXXXXXXXXXXXXXXXXXXXXXXXXXXXXXXXXXXXXXXXXXXX
