---------------------------------------------------------------------------------------------------------------------
---------------------------------------------------------------------------------------------------------------------
---------------------------------------------------------------------------------------------------------------------
---------------------------------------------------------------------------------------------------------------------
---------------------------------------------------------------------------------------------------------------------
-------------------------------CC----C----------------------------------------------------C--------------------------
----------------------------C-----C---------------------C------------------------------------C-----------------------
--------------CC----C-----C--C---C--C-----CC-C----C-C--C----C--C---------C-------C-----------------C-----------------
-------C--------C-C--C--CCP-BB-BBP----CC-C--C-C-------C----C---------C----------C-CCCC---CBBB----C-B-----------------
------C-C----C-----C---------------------------C-----CP---C--CC-CCBB-B-----C-C-C------C-C------CC--------------------
------BBB--BBB--------CC----------------C----------BBB----------------B----------------------------------------------
-----------------------------SE----EE------------P------------------------------------BBBBS-------SE-----------------
-----------------E--------XXXXXXXXXXXX----------------S-----------E-----------------------XXXX----XXXX---------------
------S----EE-XXXXS-------XXXXXXXXXXXX----E----------SXXXX-SE---E-XXXX-SE----ES----EE-----XXXX----XXXX---------------
XXXXXXXXXXXXXXXXXXXXXX----XXXXXXXXXXXX----XXXX----XXXXXXXXXXXXXXXXXXXXXXXXXXXXXXXXXXXX----XXXX----XXXX---------------
