---------------------------------------------------------------------------------------------------------------------
---------------------------------------------------------------------------------------------------------------------
---------------------------------------------------------------------------------------------------------------------
---------------------------------------------------------------------------------------------------------------------
---------------------------------------------------------------------------------------------------------------------
------------------C-CC--C----------C------------------------------------------------------C-CCC----------------------
--------------------------------------------------------CCCCC-------------CC-------C-C----------C--------------------
----------------------C----CC-C---C------------------C-------C-----C----------------C--C-----------------------------
--------C--CC--CC---------------CC----C--C-C--CC-C-C------------CC---CC-CC------------C-CCPB-------------------------
-------C---PPB---C--------C------------C--C-C---C-----------------C----C-----------BBB-------------------------------
------C-------C------------P-BPP----------------PBBBPB--------CC---PBPBBP------C------BBBB---------------------------
--------------BB--E----ES----------EE--------B-------------SE----B------------------------S----SS--------------------
-----------EE-----XXXXXXXX--------XXXX----------------E---XXXX---------------E-----EE-----XXXXXXXX-------------------
XXXXXX----XXXX----XXXXXXXX---SE---XXXX---------EE----EXXXXXXXX----E----EE-XXXX----XXXX---SXXXXXXXX-------------------
XXXXXX----XXXX----XXXXXXXXXXXXXXXXXXXX--------XXXXXXXXXXXXXXXX----XXXXXXXXXXXX----XXXXXXXXXXXXXXXX-------------------
