--------------------------------------------------------------------------------------------------------------------
--------------------------------------------------------------------------------------------------------------------
--------------------------------------------------------------------------------------------------------------------
--------------------------------------------------------------------------------------------------------------------
--------------------------------------------------------------------------------------------------------------------
------------------------------------BBBBBBB-------------------------------------------------------------------------
--------------------------------------------------------------------------------------------------------------------
------------------------------------C-------------------------------------------------------------------------------
--------------------------------------------------------------------------------------------------------------------
-----------------------------B-----BB----------------------------------------------------------B--------------------
----------------------------------------------------------------------------------------SX--------------------------
-------------------------------------------------------------------------X-------------EEX--------------------------
--------------------------------------------------------------------------XX-------C-C-EEX--------------------------
XXXXXXXXXXXXXXXXXXXXXXXXXXXXXXXXXXXXXXXXXXXXXXXXXXXXXXXXXXXXXXXXXXXXXXXXXXXXXXXXXXXXXXXXXXXXXXXXXXXXXXXXXXXXXXXXXXXX
