-----------------------------------------------------------------------------------------------------
-----------------------------------------------------------------------------------------------------
-----------------------------------------------------------------------------------------------------
-----------------------------------------------------------------------------------------------------
----------------------------------------------------------------------------------CC-----------------
-E-------------------------B----------BBBBB------------------------------------------------CC---CC---
XX-----------------------------------------------------------E---------------------------------------
XX----------------------------------------------------------XX---------------------------------------
XX----CCC---------------------------------------------------XX------------------------------XX-------
XXX--------E--------------BB--------------------------------XX-----E---------------XXXXXXXX-------XXX
----------XX------------E--------------E--------------------------XX----------XX---------------------
----------XX-----------XX-------------XX------------------------X-XX----------XX---------------------
----------XX----E------XX-------------XX-E-------------EE------XX-XXEE--------XX---------------------
XXXXXXXXXXXXX-XXXX-XXXXXXXXXXXXXXXXXXXXXXXXXXXXXXXXXXXXXXXXXXXXXXXXXXXXXXXXXXXX----------------------
