-----------------------------------------------------------------------------------------------------
-----------------------------------------------------------------------------------------------------
-------------------BBBBBBBBBBBBBBBBBBBBBBBBBBBBBB----------------------------------------------------
---------------------------BBB---BBBBBBB-------------------------------------------------------------
---------------------------BBB---BBBBBBB-------------------------------------------------------------
--CC-XXXCCC-----------------BB-----------------------------------------------------------------------
XXX-------------------------BB-----------------------------------------------------------------------
C---------------------------BB--------------------------------------------------------------------C--
----------XXX---------------BB----E---------------------------------------E-----BBB----------------E-
----XX----------------E-----BB---BBBBBBB--------B------------------------XX-----------B----------BBBB
---------------------XX--E------EE-----------------------B---------------XX--------------------------
---------------------XX-XX-------------------X-----------b---------------XX-------------------------E
---------------------XX-XX---E--------------XX-E---------B---------------XX--------------------------
--------------XXXXXXXXXXXXXXXXXXXXXXXXXX-XXXXXXXX-------XXXXXXXXXXXXXXXXXXXXXXXXXXXXXXXXXXXXXXXXXXXXX
