-----------------------------------------------------------------------------------------------------
-----------------------------------------------------------------------------------------------------
-----------------------------------------------------------------------------------------------------
-------------------------------------------------------------------E----E-E--------------------------
CC---------------------------------------------------------------XXXXXXXXXXXXXX----------------------
---------------X-----XXXXXXXX--------BB------------------------------------------BBBBB---------------
--------BB-----X-------------------------------------------------------------------------------------
-------------XXX-------------------------------------------------------------------------------------
------------XXXX--------------------------------------BBBB-------------------------------------------
-----------XXXXX-----------------E---BB-------BB--------------------------------X-----------BB-------
----------XXXXXX-----------------E----------------------------------------------X-------------------X
-XXXXXX--XXXXXXX----------------------------------B-----------------------------XX-----------------XX
--------XXXXXXXX-------------------EE-------------b-----------------------------XX--E---X---------XXX
--------XXXXXXXXXXXXXXX------XXXXXXXXXXXXXXXXXXXXXXXXXXXXXXXXXXX----------------XXXXXXXXXXXXXXXXXXXXX
