-----------------------------------------------------------------------------------------------------
-----------------------------------------------------------------------------------------------------
-----------------------------------------------------------------------------------------------------
-----------------------------------------------------------------------------------------------------
-----------------------------------------------------------------------------------------------------
E----------------------------------X-----------------------------------------------------------------
X----------------------------------X-----------------------------------------------------------------
X---------------------------------XX------------------------------------XXX--------------------------
XX--C-----------------------------XX------------B-------------------------------PPP------------------
--------------BB-------------XXXX-XX-----------E----------------------X-------------------BBBBB------
------------E---------------------XX-----------E-----------------------------------------------------
-----------XX---------------------XX-----------------------------------------------------------------
------E----XX---------------------XX-----E-----------------------------------------------------------
XXXXXXXXXXXXXXXXXXXXXXXXXXXX------XXXXXXXXXXXXXXXXXXXXXXXXXXXXXXXXXXXX------XXXXXXXXXXXXXXXXXXXXXXXXX
