-----------------------------------------------------------------------------------------------------
-----------------------------------------------------------------------------------------------------
-----------------------------------------------------------------------------------------------------
-----------------------------------------------------------------------------------------------------
------------------------------------------------------------------------------------------------E----
XXXX---P----------------------BBBBB---BBBBBBBBBBBBBBBB-----------------------------------------BBBBB-
XXXX-------------------------------------------------------------------------------------------------
XXXX-------------------------------------------------------------------------------------------------
XXXX---------------------------------B-------------------E--------B---------------------------------E
XXXX---B--------BBBB------X--X------------E-------------XX---------------------BB--------------------
XXXX-------------------------X------------------E-------XX-------------------------------------------
-----------------------------X-------------------------XXX--------------------------XX---------------
-----------------------------X--E-------------------E--XXX------------E-------------XX--XX-----------
XXXXXXXXXXXXXXXXXXXXXXXXXX--XXXXXXXXXXXXXXXXXXXXXXXXXXXXXXXXXXXXXXXXXXXXXXXXXXXXXXXXXXXXXXXXXXXXXXX--
