---------------------------------------------------------------------------------------------------------------------
---------------------------------------------------------------------------------------------------------------------
---------------------------------------------------------------------------------------------------------------------
---------------------------------------------------------------------------------------------------------------------
---------------------------------------------------------------------------------------------------------------------
-----------------------C------------------------------------------------------------C----C---C-----------------------
----------C--C--------C-CC-C--------------C---CC-C---------C------C-------C-----C-------C-------CC-------------------
------------C---C---C-----C---------C--C-C-----------CC------C--C----CC-----------CC----------C----------------------
------C-C--C---C-C---C----BPPBC--------------CBBBBC-C--C--C-C------CC--C-C-------C--------P-B------C-----------------
---------CPB-P-----------------P---C--C-C----P----------------CC--B-BB--C-BB-BB--------------------------------------
-------C------PB----------------------------------BBB-B----------------BBB-------------------------------------------
--------B--------------ES----E-----------------EE----------------------------------EE----SE----ESE-------------------
-----------EE-----E---XXXXXXXXS-----------S---XXXX---------EE-----E----------EE---XXXXXXXXXXXXXXXX-------------------
XXXXXX----XXXX---EXXXXXXXXXXXXXXXX-EE----EXXXXXXXX---SS---XXXX---SXXXX-EE-XXXXXXXXXXXXXXXXXXXXXXXXXXXX---------------
XXXXXX----XXXXXXXXXXXXXXXXXXXXXXXXXXXXXXXXXXXXXXXXXXXXXXXXXXXXXXXXXXXXXXXXXXXXXXXXXXXXXXXXXXXXXXXXXXXXXXXX-----------
