---------------------------------------------------------------------------------------------------------------------
---------------------------------------------------------------------------------------------------------------------
---------------------------------------------------------------------------------------------------------------------
---------------------------------------------------------------------------------------------------------------------
---------------------------------------------------------------------------------------------------------------------
-----------------------C------------------------C----C-----------------------------CC--C-----------------------------
---------------------------------C------------CC--C-C-C----------------C-------------C----C-C-----CC-----------------
------------CC--CC----C-C-C--C-C---------C-C-----C------------CCCC-------C--------C---C-C----------------------------
--------CC----C---C-C------C--BPB--C--C---C-----BB-BPB--C----------CCCBPB--C-C---C-PB--PPPBB---C---------------------
------------P------C-C---------------C--C--------------B-----C--------------C---C-------------C----------------------
------CC------B--------------P-----------------------------------BC-------C----------------------C-------------------
-----------------------EE-----S----------------ES----E------------B-B--EE-B--------ES----EE--------------------------
-----------S-E--------XXXX----XXXX------------XXXXXXXXE---------------XXXX--------XXXXXXXXXXXX----EE-----------------
XXXXXX----XXXX---EE---XXXX---SXXXX-EE----SE---XXXXXXXXXXXX-ES----S----XXXX----E---XXXXXXXXXXXX----XXXXXXXX-----------
XXXXXX----XXXXXXXXXXXXXXXXXXXXXXXXXXXXXXXXXXXXXXXXXXXXXXXXXXXXXXXX----XXXX----XXXXXXXXXXXXXXXX----XXXXXXXX-----------
