---------------------------------------------------------------------------------------------------------------------
---------------------------------------------------------------------------------------------------------------------
---------------------------------------------------------------------------------------------------------------------
---------------------------------------------------------------------------------------------------------------------
---------------------------------------------------------------------------------------------------------------------
------------------------------------------CC----------C-C-------------C-CC---------CC--C-----------------------------
------------------CCC------C-C--------CC-C--C----------C-C-----------C----------------------------C------------------
----------------C-----------C--C-CC-----C----C---------------------C---C----------C--CC--C------C--------------------
------CC----CC---C---C----C-----C----C-------B-------C--------CC--C-C-BBBB---C-C------BB-BC--C-----------------------
--------C-BP---C-------C-C-BPB----------------C--C---------------C--P------C-----C---------CC-C----------------------
------PPBB--------------C----------------------C----C--------C--C-----------C-C-C---------B--------------------------
------------------------BB---------------SS---BPBBBBBBS----------------EE-BB-------EE----E---------------------------
-----------ES-----S----------S-----EE-XXXXXXXX--------XXXX---------E--XXXX--------XXXXXXXX--------EE--XXXX-----------
------E---XXXX---SXXXX----XXXXE---XXXXXXXXXXXX--------XXXX--------XXXXXXXX--------XXXXXXXXE----EE-XXXXXXXX-----------
XXXXXXXXXXXXXXXXXXXXXX----XXXXXXXXXXXXXXXXXXXX--------XXXX--------XXXXXXXX--------XXXXXXXXXXXXXXXXXXXXXXXX-----------
