--------------------------------------------------------------------------------------------------------------------
--------------------------------------------------------------------------------------------------------------------
-----------------------X--------------------------------------------------------------------------------------------
----------------------XX--------------------------------------------------------XX----------------------------------
----------------------XX--------------------------------------------------------------------------------------------
----------------BBBXBXBBXXX------------B---------------------------------BB---BBBBP---------------------------------
--------------------------------------------------------------------------------------------------------------------
--------------------------------------------------------------------------------------------------------------------
--------------------------------------------------------------------------------------------------------------------
------------------------------------B---------------------------------------------------------X---------------------
-------------------------------------------------------------------------------------------X-XX---X-----------------
------------------------------SXX-------SXX-----------------------------------------------XXXXX--XXX----------------
------------------------------EEX-------EXX----------------------------------------------XXXXX-X-XXX----------------
XXXXXXXXXXXXXXXXXXXXX---XXXXXXXXXXXXXXXXXXXXXXXXXXXXXXXXXXXXXXXXXXXXXXXXXXXXXXXXXXXXXXXXXXXXXXXXXXXXXXXXXXXXXXXXXXXX
