---------------------------------------------------------------------------------------------------------------------
---------------------------------------------------------------------------------------------------------------------
---------------------------------------------------------------------------------------------------------------------
---------------------------------------------------------------------------------------------------------------------
---------------------------------------------------------------------------------------------------------------------
---------------C--------------------------------------C-C-------------CC---------C--------------C--------------------
-------CCC-C--C--C---------------CCC-C-----C-----------C-----C----------------------CC-------------------------------
-----------------------------C--------------------C-C----C-C------CCC-------------C-----------C--C-------------------
------------CCB---C--CC----C---C------CC--C-C--------CB---C---C--C----BBB--CC---------------------C------------------
------B---BPBB---------C-CC---B---------------CC--B-PP-----------------------------B-PC--CCC-C-----------------------
--------------------C---BB-BBB----------------PBBB----------------BBPB----C------------CC----------------------------
-----------------E------------------------------------E----------------EE-----E--------B-------ESE-------------------
------E----ES-XXXX------------E----SE-----E----------EXXXX-EE---------XXXX----XXXX-SE---------XXXX----XXXX-----------
XXXXXXXXXXXXXXXXXX-----EE----EXXXXXXXX---EXXXX-EE-XXXXXXXXXXXX----E---XXXX----XXXXXXXX----E---XXXX----XXXX-----------
XXXXXXXXXXXXXXXXXX----XXXXXXXXXXXXXXXXXXXXXXXXXXXXXXXXXXXXXXXX----XXXXXXXX----XXXXXXXX----XXXXXXXX----XXXX-----------
