-----------------------------------------------------------------------------------------------------
-----------------------------------------------------------------------------------------------------
-----------------------------------------------------------------------------------------------------
-----------------------------------------------------------------------------------------------------
-----------------------------------------------------------------------------------------------------
-------P-BBBB-----------------------------E-C----------------BB--------------XX------BBBBBBB---------
-E------------------------------------XXXXXXXXXX-----------------------------------------------------
XX-------------------------------X-----------------XXXXXX--------------------------------------------
XX-------------------------B-----X---------------------------BB--------------------------------------
XXX----B------------------E-----XX-XX---------------------------------------------BBBB---------------
--------------------------E-----XX-------------------------------------------------------------------
--------------------------------XX-----------------------------------XXXXXXXX------------------------
--------------------------------XX-------------------------------X--------------------E--------E-----
XXXXXXXXXX----XXXXXX-XXXXXXXXXXXXX------------XXXX-------------XXXX------------XXXXXXXXXXXXXXXXXXXX--
