--------------------------------------------------------------------------------------------------------------------
--------------------------------------------------------------------------------------------------------------------
--------------------------------------------------------------------------------XX----------------------------------
-------------------------------------------------------------------------------XXXX---------------------------------
-------------------------------------------------------------------------------XXXX---------------------------------
-----------------------XXX-----BBB--BBB----------------------------------------BXXXXX----BP-------------------------
--------------------------------------------------------------------------------------------------------------------
--------------------------------------------------------------------------------------------------------------------
--------------------------------------------------------------------------------------------------------------------
----------------PB-----------B--------------------------------------------------------------------------------------
--------------------------------------------------------------------------------------------------------------------
--------------------------------------X-----------------------------------------------------------------------------
--------------------------------------XXC----------------------------------------------------------CC---------------
XXXXXXXXXXXXXXXXXXXXXXXXXXXXXXXXXXXXXXXXXXXXXXXXXXXXXXXXXXXXXXXXXXXXXXXXXXXXXXX------XXXXXXXXXXXXXXXXXXXXXXXXXXXXXXX
