-----------------------------------------------------------------------------------------------------
-----------------------------------------------------------------------------------------------------
----------------------------------------------------------C------------------------------------------
--------------------------------------------------P------XXX-----------------------------------------
-----------------------------------------------------------------------------------------------------
------------BB------------------B--------------------------------------------------B-----------------
-------------------XX--C-----------------------------E-----------------------------------------------
---------E---------C-----------------------------XXXXXX----------------------------------------E-----
--------XX-------------------------C----------------------------------------------------------XX-----
--------XX-EPB-------------------E--C----------XX-----CCC-------------------------------------XX-----
--------XX----------------------XX----------------------E--------XX-----------------E---------XX--E--
--------XX----------------------XX--------------XXXXXXXXXX-------XX--------------B-XX---------XX-----
BBB-----XX-----E--------------E-XX-------------------------------XX--------------b-XX---------XX-----
--XXXXXXXXXXXXXXX------XXXXXXXXXXXXXXXXXX-XXXXX--------------XXXXXXXXXXX-XXXXXXXXXXXXXXXXXXXXXXXXX-XX
