--------------------------------------------------------------------------------------------------------------------
--------------------------------------------------------------------------------------------------------------------
-----------------------XX-------------------------------------------------------------------------------------------
---------------------XXXX-------------------------------------------------------------------------------------------
----------------------XXX-------------------------------------------------------------------------------------------
---------------------XXXXXX----------BBBBBB------------------------------BB-----P-----------------------------------
--------------------------------------------------------------------------------------------------------------------
------------------------------------C-------------------------------------------------------------------------------
--------------------------------------------------------------------------------------------------------------------
------------------------------------B-------------------------------------------------------------------------------
--------------------------------------------------------------------------------------------------------------------
--------------------------------------------------------------------------------------------------------------------
----------------------------------------------------------------------------------------C-----------C---------------
XXXXXXXXXXXXXXXX--XXX------XXXXXXXXXXXXXXXXXXXXXXXXXXXXXXXXXXXXXXXXXXXXXXXXXXX--------XXXXXXXXXX-XXXXXXXXXXXXXXXXXXX
