-----------------------------------------------------------------------------------------------------
-----------------------------------------------------------------------------------------------------
-------------------------------------------------------BBBBBBBBBBBBBBBBBB----------------------------
-----------------------------------------------------------------------------------------------------
----------------------CC----------------------E------------------------------------------------------
--------------------------------------------BBBBBBBBBBB----------------------------------------BBB---
-----------------------------XXXX--CC----------------------------------------------------------------
-----------------------------------------------------------------------------------------------B---C-
---------------------------------------------------------E----------E-----------------------BBB-B---E
--E------------------------------------BB---B---BBBBBBB-XX---------XX----------------------------BBBB
XXX-----------------------------------------------------XX---------XX-BBB----X---------E-------------
XXX--------------------XXXXXXX--------------------------XX---------XX-BBB---XX--------XX-------------
XXX---------------------------------------------E-------XX----E----XX-BBB--XXX--------XX--E----------
-XXXXXXXXXXXX---XXXXX--------------XXXXXXXXXXXXXXXXXXXXXXX-XXXXXXXXXX-XXXXXXXXXXXXXXXXXXXXXXXXXXXXXXX
