---------------------------------------------------------------------------------------------------------------------
---------------------------------------------------------------------------------------------------------------------
---------------------------------------------------------------------------------------------------------------------
---------------------------------------------------------------------------------------------------------------------
---------------------------------------------------------------------------------------------------------------------
--------------------------C-------------CC---------------------------------------------------------------------------
----------C-----------------CC---------C---C-----------------------------C---C---------------CC--C-C-----------------
------------CCC-------C--C-C--------------C------------CC---C-C--CC--C--C---C-------------CC------C------------------
-------C-C-C-------C------B-BPC-C--C--------C-CC--CC---------------CC-PB-P-C--------C----CBBBP-CC--------------------
------C-C-BBPB---C----------------C--C-------B--------C------C--C--PB-----BPB----------C-----------------------------
---------------------C-----------C-------------------B---------------------------CC--C---B---------------------------
------BBPB-------------------EBPB-------E-----B-B----------------------SS-----------------E-------E------------------
-----------ES----------SE-XXXX--------XXXXE-----------------------E---XXXX---E------------XXXX-EEEXXXX---------------
XXXXXX----XXXX---S----XXXXXXXX--------XXXXXXXX-------SS----EE----EXXXXXXXXXXXX-----------EXXXXXXXXXXXX---------------
XXXXXX----XXXXXXXX----XXXXXXXX--------XXXXXXXX----XXXXXXXXXXXXXXXXXXXXXXXXXXXX--------XXXXXXXXXXXXXXXXXXXX-----------
