---------------------------------------------------------------------------------------------------------------------
---------------------------------------------------------------------------------------------------------------------
---------------------------------------------------------------------------------------------------------------------
---------------------------------------------------------------------------------------------------------------------
---------------------------------------------------------------------------------------------------------------------
------------------------------------------------------------------------------------CCC------------------------------
-------C-C-----CC------CC-------------------------C-----------C-------CC-CC------C--------C--C-----------------------
--------C----------C---------C-C-C----------CC-------C------C--CCC----------CC-----C----C--CC------C-----------------
--------------C-------C--CC-----C-C---C----C-------C-----C------------B-B-----CC-------PBB-------C-------------------
------BBP-CCC-----C--------C---------C-CC-C---CC---B---C----------------------------------BP-P-----------------------
----------PBBB----------------B-PB----------BBBPBB----C-----------------------------------------C--------------------
-----------------------------------------------------------SE----EPBBP-EE----E-----EE----E---------------------------
------E----------S-----SE----------------------------S----XXXXXXXX----XXXXXXXXE---XXXXXXXXE-------EE-----------------
XXXXXXXXXX-SE-XXXXE---XXXX---EE---------E-S----EE-XXXX----XXXXXXXX----XXXXXXXXXXXXXXXXXXXXXXXX----XXXX---------------
XXXXXXXXXXXXXXXXXXXXXXXXXXXXXXXXXX----XXXXXXXXXXXXXXXX----XXXXXXXX----XXXXXXXXXXXXXXXXXXXXXXXX----XXXX---------------
