-----------------------------------------------------------------------------------------------------
-----------------------------------------------------------------------------------------------------
------------------------CC---------------------------------------------------------------------------
------------------------XXX--------------------------------------------------------------------------
-----------------------------------------------------------------------------------------------------
BB-----------------------------------------C--C--------------------------BBBBBB----------------------
--------------------------------XXX---------------------------------------------------E--------------
----------------XX------------------XX-----------------------------------------------XX-----------XX-
---------------------C---------------------------------------------------BBBBBB------XX--------------
---------------------------------------XXXX-XX-X--------BB---------------------------XX--------------
B-------------XXX-------XXXXXXXXX-------------------E-----------------X---------------------EX--XXX--
b--------------------------------------------------XX-------------XX-XX----------X------XX--XX-------
B----E----E-E-----------------------------------------------------XXXXX---------XX-E----XXXXXX-------
XXXXXXXXXXXXXX------------------------------------XXXXXXXXXXXXXXXXXXXXX--------XXXXXXXXXXXXXXXXX-----
