---------------------------------------------------------------------------------------------------------------------
---------------------------------------------------------------------------------------------------------------------
---------------------------------------------------------------------------------------------------------------------
---------------------------------------------------------------------------------------------------------------------
---------------------------------------------------------------------------------------------------------------------
-----------------------CC----------------------CC----C-----C---CCC--------CC-C---------------------------------------
---------------C----C-C-----------C-----------C-----------C----------C------C----C-----------------------------------
-----------CC---C-CC-----CCCC-C-----C--C----C-------C----C----------C-----------C------CCC--C-----C------------------
-------C--C---C--C-------B---C-----C----CC---C-BBPPPBPC--------------B---CPPP--------C-----------C-------------------
------C------CP-----------------------C----------------CC---------------------------C------C-CCC---------------------
-------BBB-BBB------------BBBB------------------------B----------------C----------CC--BBBBPP-------------------------
-----------------------SE----------------------SE----E-----EE----EE---B-BP---E---------------------------------------
-----------------EE---XXXX--------E-S---------XXXXXXXX----XXXXXXXXXXXX----XXXXE-------------------SE-----------------
------S----ES-XXXXXXXXXXXX---EE---XXXX---ES---XXXXXXXXE---XXXXXXXXXXXX----XXXXXXXX-------ES-------XXXXXXXX-----------
XXXXXXXXXXXXXXXXXXXXXXXXXXXXXXXXXXXXXXXXXXXXXXXXXXXXXXXXXXXXXXXXXXXXXX----XXXXXXXX----XXXXXXXX----XXXXXXXX-----------
