-----------------------------------------------------------------------------------------------------
-----------------------------X-----------------------------------------------------------------------
BBBBBBBBBBBBBBBBBBBBBBBBBBBB-------------------------------------------------------------------------
------BBB--------------------------------------------------------------------------------------------
------BBB----------------------X---------------------------------------------------------------------
----------------------------------XCC------X-CC--C------------X-------------------------B------------
-------------------------------------------------------------XX--------------------------------------
------------------------------------------------------------XXX--------------------------------------
-------E------------B-------------------------XXXXXXXXXXXX--XXX--------------------------------------
------BBB--------E------E--------X---X-XXXXXX---------------XXX------------BBB----X-BBBPB------------
X----EE---BB----XX-----XX--XX-------------------------------XXX----------E-----X-XX------------------
X---------BB----XX-----XX--XXX------------------------------XXX-----B---XX-----XXXX------------------
X--E------BB----XX-----XX--XX-------------------------------XXX---E-b----------XXXX----E-EEE---------
--XXXXXXX-XX-XXXXXXXXXXXXX-X--------------------------------XXXXXXXXXXXXXXXXXXXXXXX-XXXXXXXXXXXXXXXXX
