--------------------------------------------------------------------------------------------------------------------
--------------------------------------------------------------------------------------------------------------------
--------------------------------------------------------------------------------------------------------------------
---------------------------------------------------------------------------------X----------------------------------
---------------------------------------------------------------------------------X----------------------------------
-------------------B----------------BBB----------------------------------------BBBXX-----BBB------------------------
--------------------------------------------------------------------------------------------------------------------
--------------------------------------------------------------------------------------------------------------------
--------------------------------------------------------------------------------------------------------------------
----------------PB-----------B--------XX--------------------------------------B-------------------------------------
--------------------------------------XX----------------------------------------------------------------------------
-------------------------------------XXX----------------------------------------------------------------------------
------------------------------------XXXXX-C------------------------------------------------------XC-----------------
XXXXXXXXXXXXXXXXXXXXXXXXXXXXXXXXXXXXXXXXXXXXXXXXXXXXXXXXXXXXXXXXXXXXXXXXXXXXXXXXX-XXXXXXXXXXXXXXXXXXXXXXXXXXXXXXXXXX
