---------------------------------------------------------------------------------------------------------------------
---------------------------------------------------------------------------------------------------------------------
---------------------------------------------------------------------------------------------------------------------
---------------------------------------------------------------------------------------------------------------------
---------------------------------------------------------------------------------------------------------------------
------------C------C-C-----C----------------------------------------------------------C----C-------------------------
-------C--CC------C-----CCC--------------C---CC-C-------------------------CCC-----C-C--C--C--CC-C--------------------
---------C-------C-----C----------------C--C------C--C--------------------------C--------C-----C-C-------------------
------C---PBB-C-------------BB-----C-C-C--------BP------C--C-CC--CC--------------C-C-C--BB-P------C------------------
------PBBP-----CC--------------CC---C-------------B----C-C-----CC--CC-C--C---------PBB-------------------------------
------------------------------PPPBC----------------------------------C-CC--------------------------------------------
-----------EE-----E----------E----B-------E----ES-----------------B-PBBBBP---------------ES--------------------------
------E---XXXX----XXXX-ES-XXXX-----------EXXXXXXXX---E-----SS---------------E-S----SS-XXXXXXXX-EESSE--XXXX-----------
XXXXXXXXXXXXXX---EXXXXXXXXXXXXE-------XXXXXXXXXXXXXXXX-S--XXXX------------XXXXXXXXXXXXXXXXXXXXXXXXXXXXXXXX-----------
XXXXXXXXXXXXXXXXXXXXXXXXXXXXXXXXXX----XXXXXXXXXXXXXXXXXXXXXXXX------------XXXXXXXXXXXXXXXXXXXXXXXXXXXXXXXX-----------
