--------------------------------------------------------------------------------------------------------------------
--------------------------------------------------------------------------------------------------------------------
--------------------------------------------------------------------------------------------------------------------
--------------------------------------------------------------------------------------------------------------------
--------------------------------------------------------------------------------------------------------------------
-------------------------------BBBBBB------------------------------------BBP---BBB-------------BBBB-B---------------
--------------------------------------------------------------------------------------------------------------------
------------------------------C-------------------------------------------------------------------------------------
--------------------------------------------------------------------------------------------------------------------
--------------------BBPB--P--PB----B--------------------------------------------------------------------------------
--------------------------------------------------------------------------------------------------------------------
--------------------------------------------------------------------------------------------------------------------
----------------X------------------------C--------------------------------------------------------------------------
XXXXXXXXXXXXXXXXXXXXXXXXXXXXXXXXXXXXXXXXXXXXXXXXXXXXXXXXXXXXXXXXXXXXXXXXXXXXXXX----XXXXXXXXXXXXXXXXXXXXXXXXXXXXXXXXX
