---------------------------------------------------------------------------------------------------------------------
---------------------------------------------------------------------------------------------------------------------
---------------------------------------------------------------------------------------------------------------------
---------------------------------------------------------------------------------------------------------------------
---------------------------------------------------------------------------------------------------------------------
--------CC------C--------------------C--C-----------------------------------------CC-C-------------------------------
------C-------CC------C-CC-CC------C-----------------------CC-------C------------------------------------------------
--------------------------C---------C-----------------CCC-C-------CC-C--CC----------C----------CC--C-----------------
---------B--------C-------------C---------C---CC--C--C---C----CC--BBBBC-----C---------------CCC----------------------
-------------------CCC-------B---C-----------------C------------C---------CC-C-----------C-C-------------------------
-------------C-----------------C-----------C----BB--C-B----------C----BBBP----C-CC--------C--------------------------
------S----B-B---S-----EE-----BP-B-EE----S---------P-B-----EE-----E-------BB-------EE-BBBPBBBP-----------------------
XXXXXXXXXX----XXXX----XXXX---E----XXXXXXXX----------------XXXX----XXXX------------XXXX---------S-S-------------------
XXXXXXXXXX----XXXXE---XXXXXXXX----XXXXXXXX-----EE-----E---XXXX----XXXX-EE---------XXXX--------XXXXEE-----------------
XXXXXXXXXX----XXXXXXXXXXXXXXXX----XXXXXXXX----XXXX----XXXXXXXX----XXXXXXXX--------XXXX--------XXXXXXXX---------------
