--------------------------------------------------------------------------------------------------------------------
--------------------------------------------------------------------------------------------------------------------
--------------------------------------------------------------------------------------------------------------------
--------------------------------------------------------------------------------------------------------------------
--------------------------------------------------------------------------------------------------------------------
---------------BB---BBBB------------------------------------------------------BP------------------------------------
--------------------------------------------------------------------------------------------------------------------
--------------------------------------------------------------------------------------------------------------------
--------------------------------------------------------------------------------------------------------------------
-----------------P-----------B------B----------------------------------------BB---------SX---B----------------------
---------------------------------------------------------------------------------------EE---------------------------
---------------------------------------------------------------------------------------EE---------------------------
-----------------------CC-C-----------------------------------------------C-C-C---C--C-EE--C------------------------
XXXXXXXXXXXXXXXXXXXXXX--XXXXXXXXXXXXXXXXXXXXXXXXXXXXXXXXXXXXXXXXXXXXXXXXXXXXXXXXXXXXXXXXXXXXXXXXXXXXXXXXXXXXXXXXXXXX
