---------------------------------------------------------------------------------------------------------------------
---------------------------------------------------------------------------------------------------------------------
---------------------------------------------------------------------------------------------------------------------
---------------------------------------------------------------------------------------------------------------------
---------------------------------------------------------------------------------------------------------------------
------------------------C-----CC---------------C-------------------------------------------C-------------------------
---------C---------------C-C-C--C------------C---C----------------CC-C----CC-C--------C---C--------------------------
------C-------C----CCC-C--------------C---------------------CC----------C---C----------CCC--CC-----------------------
-----------C---C----B--B--C---BP---C--------C---B-----C---------------C--------------------BBP-C--CC-----------------
--------PBB-----C---------BBBB------CC-C-----------C---C---------CBBBP---C-------C-C--PB-B----C--C-------------------
----------------------------------C----------------BB---C-----C-----------------C----C----------C--------------------
------------------E----EE-----E----------------SS-----BB-B-------P-------------------P----E--------------------------
------E----EE-----XXXXXXXX---EXXXX--------E---XXXX----------------S----------E-----------SXXXX-----------------------
XXXXXXXXXXXXXX---SXXXXXXXXXXXXXXXX-------EXXXXXXXX---E-----EE-----XXXX-EE-XXXX--------XXXXXXXX-----E--XXXX-----------
XXXXXXXXXXXXXXXXXXXXXXXXXXXXXXXXXX----XXXXXXXXXXXXXXXX----XXXX----XXXXXXXXXXXX--------XXXXXXXX----XXXXXXXX-----------
