-----------------------------------------------------------------------------------------------------
-----------------------------------------------------------------------------------------------------
-----------------------------------------------------------------------------------------------------
-----------------------------------------------------------------------------------------------------
---------------------------------------------------------EC----------------------CCC-----------------
E------------------------------------------XXX--BBB------XXX------C-E--C---------XXX-----------------
X-------------------------------C-C-C-C----XXX--------------------XXXXXXXXX--------------------------
X-----------------X------------XXXXXXXXX---XXX------------------E------------------------------------
XX-----------------------------------------XXX-----------------XX------------------------------------
-------------------------------------------XXX------B---XXXXXX-XX------------E-------------------B---
---E---------------------------------------XXX-----------------XX-----------XXXXP--------------------
--XX----------C--------B-------------------XXX-----------------XX------------------------------------
--XX--E------XXX-------b---E--E------------XXX-----EE----------XX----------------------------------E-
XXXXXXXXXXXX------XXXXXXXXXXXXXXXXXXXXXXX--XXXXXXXXXXXX------X-XXX--------------XXXX----XXXXXXXXXXXXX
