---------------------------------------------------------------------------------------------------------------------
---------------------------------------------------------------------------------------------------------------------
---------------------------------------------------------------------------------------------------------------------
---------------------------------------------------------------------------------------------------------------------
---------------------------------------------------------------------------------------------------------------------
-------------------C-----------C-C---------C----------------C--------------------------------------------------------
-------C----C-C--C--C-----C---C-C--------C---------------------------------------------------------------------------
------C-C------C--C----C------------------C-C----C--------CC------------CC----------CC--CCC---C----------------------
----------C--C--------C-CC-BBB------C--------B--C--CC--C-C-------C----C--------------------CCC-CCC-------------------
-------PBPBB--B--------------------C-C---------C--C--C------------CC--------------B--PC------------------------------
-----------------------------------------------B--PPBB--------CC----CC-----C-C--------PB-BB-------C------------------
------------------E----------EE-----------E------------B---SS--BPB-BB---------E--------------------------------------
------E----SE----SXXXX----XXXXXXXX-------EXXXX------------XXXX---------EE-----XXXX-EE--------------------------------
XXXXXXXXXXXXXXXXXXXXXX-EE-XXXXXXXX-E-EXXXXXXXX-SE----E----XXXX--------XXXX----XXXXXXXX---EE----SE--------------------
XXXXXXXXXXXXXXXXXXXXXXXXXXXXXXXXXXXXXXXXXXXXXXXXXXXXXX----XXXX--------XXXX----XXXXXXXXXXXXXXXXXXXX----XXXX-----------
