---------------------------------------------------------------------------------------------------------------------
---------------------------------------------------------------------------------------------------------------------
---------------------------------------------------------------------------------------------------------------------
---------------------------------------------------------------------------------------------------------------------
---------------------------------------------------------------------------------------------------------------------
--------------------------------------------------------------------C---------------------------C--------------------
-----------------CC--C-C---------------C-CCCCC----------C-------CC-C-------------C-C---------------------------------
------C-------CCC--------C-------CC-----C-----C---C--C-C------CC------CC-C-CC--C-----C----CC-------------------------
--------C---CC--------C-C-C---C------C-------B--C---C-C---CC---BBB-BBBBB--C--C-----------C---------------------------
---------CC------------------------CC--------------C----------------------------------C-----CC-----C-----------------
-----------------------------CBPP--B------------BBPB-----------------------------------CC-B--------------------------
----------BBBB---ES---------B------------ES----------------------EE----EE----------SE--B-B-----EEE-------------------
--------------XXXXXXXX-SE-------------XXXXXXXX--------S----SS-XXXXXXXXXXXX----E---XXXX--------XXXX-------------------
------E-------XXXXXXXXXXXX----E---E-S-XXXXXXXX-EE----SXXXXXXXXXXXXXXXXXXXX---EXXXXXXXX----E---XXXXSE--XXXX-----------
XXXXXXXXXX----XXXXXXXXXXXX----XXXXXXXXXXXXXXXXXXXXXXXXXXXXXXXXXXXXXXXXXXXXXXXXXXXXXXXX----XXXXXXXXXXXXXXXX-----------
