---------------------------------------------------------------------------------------------------------------------
---------------------------------------------------------------------------------------------------------------------
---------------------------------------------------------------------------------------------------------------------
---------------------------------------------------------------------------------------------------------------------
---------------------------------------------------------------------------------------------------------------------
-----------CCC------------------------------------------------C-C-C------C-------C-----------------------------------
------------------C---C--------CCC------C--C------------C--C---------C------C-C-------------------C------------------
---------------CC---CC-----C-CC-----------------------C--CC----C--------C-C--C-C--------C----------C-----------------
----------BBBPC----------CC-C-------C-------C------CCC-C----C---B-BP-B------------CC-C-C-CCC-------------------------
-------C-----------------------BBP----------B-----------------------------------------BPB----C-C---------------------
--------CC----B------------B-B----------------P-BBB---------------------------------C-------C---C--------------------
-------BBP-SE-----E---------------PB-----------------------------EE----EE-----E---BB-B-------------E-----------------
XXXXXX----XXXX----XXXX-EE-----E----------SE-----------E----EE-XXXXXXXXXXXX---EXXXX-------S--------XXXX---------------
XXXXXX----XXXX---SXXXXXXXX---EXXXX----XXXXXXXX-SE----SXXXXXXXXXXXXXXXXXXXXXXXXXXXX----XXXX--------XXXX---------------
XXXXXX----XXXXXXXXXXXXXXXXXXXXXXXX----XXXXXXXXXXXXXXXXXXXXXXXXXXXXXXXXXXXXXXXXXXXX----XXXX--------XXXXXXXX-----------
