---------------------------------------------------------------------------------------------------------------------
---------------------------------------------------------------------------------------------------------------------
---------------------------------------------------------------------------------------------------------------------
---------------------------------------------------------------------------------------------------------------------
---------------------------------------------------------------------------------------------------------------------
------C---------------------CCC----C-C------------------------------------------CC-------C---------------------------
---------C---------------C-C--------------C-C---C-----------------------C---------C-C--CC--------C-------------------
-------C-------C------CC-------CCC--C------C-CCC---------------C-----C-C-C----C------C-----C-CC----------------------
-------BB---CC---------BBB-PBBPBBBBB-----C---B----CC----CC----C---C---------C-----------B-C--------------------------
-----------C-----------------------------------PPB----------C----C-----B------------------PP-B----C------------------
--------------B-------------------------C-----------C-CC------------B------------------------------C-----------------
------E-----BP---------EE----EE----EE-----E-------PBP-------------------------E----ES----S---------------------------
XXXXXXXXXX------------XXXXXXXXXXXXXXXX----XXXX-ES----------------------EE----SXXXXXXXXXXXXE----SEE-------------------
XXXXXXXXXX-------E----XXXXXXXXXXXXXXXX----XXXXXXXX---------------EE---XXXXXXXXXXXXXXXXXXXXXXXXXXXX-------------------
XXXXXXXXXX----XXXX----XXXXXXXXXXXXXXXX----XXXXXXXX------------XXXXXXXXXXXXXXXXXXXXXXXXXXXXXXXXXXXX-------------------
