--------------------------------------------------------------------------------------------------------------------
--------------------------------------------------------------------------------------------------------------------
--------------------------------------------------------------------------------------------------------------------
--------------------------------------------------------------------------------------------------------------------
--------------------------------------------------------------------------------------------------------------------
----------------BBBBBBBBP---------------------------------------------------BB--------------------------------------
--------------------------------------------------------------------------------------------------------------------
--------------------------------------------------------------------------------------------------------------------
--------------------------------------------------------------------------------------------------------------------
----------------PB------------------XX-X-----------------------------------B--P--P-------SX-----XX------------------
---------------------------------XXXXX-XX------------------------------------------------EX----XXXX-----------------
-------------------------------XXXXXXXXXXX-----------------------------------------------ESX--XXXXXX----------------
---------------------C-C-------XXXXXXXXXXX-------------------------------E----C------C---EEX-XXXXXX-B---------------
XXXXXXXXXXXXXXXXXXXXXXXX--XXXXXXXXXXXXXXXXXXXXXXXXXXXXXXXXXXXXXXXXXXXXXXXXXXXXXXXXXXXXXXXXXXXXXXXXXXXXXXXXXXXXXXXXXX
