---------------------------------------------------------------------------------------------------------------------
---------------------------------------------------------------------------------------------------------------------
---------------------------------------------------------------------------------------------------------------------
---------------------------------------------------------------------------------------------------------------------
---------------------------------------------------------------------------------------------------------------------
---------------------------------C--C------------------C----CCC------------------------C--------C--------------------
-----------------C------------CCC--C----C----C--------C---C-----------------------------------C----------------------
--------------C--------C-C--------C------CC-C-----------CC------CC-------C-------C--------C-C----C-C-----------------
--------C------CC-C-C-C-------BP--------------C----C-----------PPP--C---------CC---CC--BBP---CBB--C------------------
------C------C-----C----B---CC-------------BBB---------------------C-C-C---CCC------------BBBP-----------------------
-----------C--------------CC-------------------CC-C---------------C---PBBPC------------------------------------------
---------B-BB-------------P-BBE----ES----S----BPPPP---S----EE----SPBBP-------------------E-----SE--------------------
-----------------E-----SE-----XXXXXXXXXXXXE-----------XXXXXXXXXXXX------------E----SE-XXXXS---XXXX-------------------
XXXXXX--------XXXXE---XXXX----XXXXXXXXXXXXXXXX--------XXXXXXXXXXXX-----EE-----XXXXXXXXXXXXXXXXXXXX-E-----------------
XXXXXX--------XXXXXXXXXXXX----XXXXXXXXXXXXXXXX--------XXXXXXXXXXXX----XXXX----XXXXXXXXXXXXXXXXXXXXXXXX---------------
