-----------------------------------------------------------------------------------------------------
-----------------------------------------------------------------------------------------------------
-----------------------------------------------------------------------------------------------------
-----------------------------------------------------------------------------------------------------
------------------------------------------------------------------------------------ECCCCCCC---------
---------E-------------BB------------B-----------------------------------------C--C-XXXXXXXXX--------
--------XX-------------------------------------------------------------------------------------------
--------XX-------------------------------------------------------------------------------------------
P-------XXX---------------------------------------------------------E--------------------------------
--------------------BBBB-----------------------------E-------------XX-----------XX-XXXXXXXXXXXX---E--
--------------------------------------------E-------XX-------------XX--------X-------------------XX--
----------------------------------------------------XX-------------XX----XX-XX-------------------XX--
------E------------------E------X--------------E----XX-------E-----XX----XXXXX-------------------XX--
XXXXXXXXXXXXXXXXXXXXXXXXXXXXXXXXXXXXX-XXX-XXXXXXXXXXXXXXXXXXXXXXXXXXXXXXXXXXXX------------------XXXXX
