---------------------------------------------------------------------------------------------------------------------
---------------------------------------------------------------------------------------------------------------------
---------------------------------------------------------------------------------------------------------------------
---------------------------------------------------------------------------------------------------------------------
---------------------------------------------------------------------------------------------------------------------
------------------------------C--C----------------C-----------CCC------CC----------C-CC-CC---------------------------
--------C-----------CC----CC---C---------------------------C------C------------C-------C------C-C--------------------
------------C--CC-C---------CC--C---------C--------C-C------C---------C--C----C-----C----------C-C-C-----------------
---------B---CC--C-C---------B-BBB--C-------C--CC-BB---C--------------PPBBC--C--------BB-P--C------------------------
----------------------------------C---C----C-C----------CC--------PB-B------C----------------------------------------
----------BBBB---------C---------------------B---C------------------------P---------------C--------------------------
------E----------------------S-S--BB----------BPBB---E-B---------S-----EE-----E----EE----EBBBP-----------------------
XXXXXXXXXX-------EE-------XXXXXXXX----------------XXXX-----SS-XXXXE---XXXX----XXXXXXXXXXXX-----ESS-------------------
XXXXXXXXXX-EE-XXXXXXXX----XXXXXXXX-------EE-------XXXX----XXXXXXXXXXXXXXXX---SXXXXXXXXXXXX----XXXX-E--XXXX-----------
XXXXXXXXXXXXXXXXXXXXXX----XXXXXXXX----XXXXXXXX----XXXX----XXXXXXXXXXXXXXXXXXXXXXXXXXXXXXXX----XXXXXXXXXXXX-----------
