---------------------------------------------------------------------------------------------------------------------
---------------------------------------------------------------------------------------------------------------------
---------------------------------------------------------------------------------------------------------------------
---------------------------------------------------------------------------------------------------------------------
---------------------------------------------------------------------------------------------------------------------
-----------C--------------C--------------------------C--CC----C--C------CC-------C-----------------------------------
----------C-CC-------------C----------------------CC--C-----------CC-CC-----CC-C----C-C--C---C-----------------------
---------------------C-C----C------------------CC---C--C---------------C---C-----------C---CC------------------------
------C-----PB--------C-CCB-BB---C----C--C-------CBBBBB----------BBB------C------P-C-C--C------CC--------------------
--------------C-CC--C----------B---CC--C---C----------------CC--------------------BBP-BBBP---------------------------
-------CCC----BB-----------------------------B-BBP-----------------------------------------------C-------------------
-----------EE----------------S----B------------------ES----------EE----SE-----S-----------S--------------------------
XXXXXX----XXXX------------XXXXE-------------------XXXXXXXX----XXXXXXXXXXXX---EXXXX-ES----EXXXX--------XXXX-----------
XXXXXX----XXXX---SE----ES-XXXXXXXX-------ES----ES-XXXXXXXX-EE-XXXXXXXXXXXXXXXXXXXXXXXXXXXXXXXX--------XXXX-----------
XXXXXX----XXXXXXXXXXXXXXXXXXXXXXXX----XXXXXXXXXXXXXXXXXXXXXXXXXXXXXXXXXXXXXXXXXXXXXXXXXXXXXXXX--------XXXX-----------
