-----------------------------------------------------------------------------------------------------
-----------------------------------------------------------------------------------------------------
BBBBBBBPBBBBBBBBBBBBBBBBBBBBBBBBBBBBBBBBBBBBBBBBBBBBBBBBBBBBBBBBBBBBBBBBBBBBBBBBBBBBBBBBBBBBBBBBBBBBB
----------------------BBBB------------------------------------------------------------------B--------
----------E-------E---BBBB---------------------------------------------------------------E--B--------
CCCCCCCC--BB------BB---------------------------------------------B-----------------------BBB---------
----------BB------BB---------------------------------------------B-----------------------BBB---------
BBBBBBBB--BB------BB---------------------------------------------B-----------------------BBB---------
BBBBBBBB--BB------BB--CCCPP-----------------------E-----------E--B-----------------------BBB------B--
----------BB---E--BB--BBBB-----------------------XX----------XX--B---------------E-------BBBB--------
--------------XX---------------------------------XX----B-----XX-----------------XX----------B-------X
--------------XX---------------------------------XX----B-----XX-----------------XX----------B-------X
--------------XX---------------------E---------E-XX----B-----XX-----------------XX-E--EE---E--------X
XXXXXXXXXXXXXXXXXXXXXXXXXXXXXXXXXXXXXXXXXX--XXXXXXX--X-X-----XXXXXXX--XX----XXXXXXXXXXXXXXXXXXXXXXXXX
