-----------------------------------------------------------------------------------------------------
-----------------------------------------------------------------------------------------------------
-----------------------------------------------------------------------------------------------------
--P--------------------------------------------------------------------------------------------------
----------------------------------------E------------------------------------------------------------
------X----CC---XXX--------------------BBBPB----------------------------------XXX--------------------
C----------X------------------------------------E-----------------------------XXX--------------------
XXXX-------------------------------------------XX-----------------------------XXX--------------------
-----------------------------------------------XX-------------C------BB-------XXX--------------------
-------------XXX-----------BBBBB-------BBBBB---XXXX-------------XXXX----------XXX--------------------
------------------------------------------------------------------------------XXX--------------------
XXXXXX---------------XX-------------------------------------------------------XXX------------B-------
---------------------XX----------E--E--------------------------------BBBB-----XXX------X-EE--b-------
--------XXX-----XXXXXXXXXXXXXXXXXXXXXXXXXXXXXXXXXX--XXXXXXXX------------XX----XXXXXXXXXXXXXXXXXXXXX--
