---------------------------------------------------------------------------------------------------------------------
---------------------------------------------------------------------------------------------------------------------
---------------------------------------------------------------------------------------------------------------------
---------------------------------------------------------------------------------------------------------------------
---------------------------------------------------------------------------------------------------------------------
-------------------------------------------C-C------CC----------------------------CC--CCC----C-----------------------
------C-----------------C-C--C---------C-----------C---------------------C---C-------------C-------------------------
--------C----------C--CC-C-------C-CCCC---------------C-C----------C--CC---CC-------CC---C--C------------------------
------B-B-------C---------BBBB----C------C--BB-CCC-------C----C-CC--C-----BP---C-C------P-PPBB-CCC-C-----------------
-------------CCC--------------CCC-------------C------------CCC----C---BB-B-------------------------------------------
----------BPB----C------------B----------------PBB---------------BP-BP-----------------------------------------------
------E-----------E----EE----E------------E----------E-----------------------E-----SE----SE---P----------------------
XXXXXXXXXX--------XXXXXXXXXXXX-----------EXXXX----XXXX-----------------ES-XXXXE---XXXXXXXXXXXX-----------------------
XXXXXXXXXX-EE-----XXXXXXXXXXXXE----SE-XXXXXXXX-SE-XXXXE----EE----EE---XXXXXXXXXXXXXXXXXXXXXXXX----ES-----------------
XXXXXXXXXXXXXX----XXXXXXXXXXXXXXXXXXXXXXXXXXXXXXXXXXXXXXXXXXXXXXXXXXXXXXXXXXXXXXXXXXXXXXXXXXXX----XXXXXXXX-----------
