---------------------------------------------------------------------------------------------------------------------
---------------------------------------------------------------------------------------------------------------------
---------------------------------------------------------------------------------------------------------------------
---------------------------------------------------------------------------------------------------------------------
---------------------------------------------------------------------------------------------------------------------
-----------------------C--------------------------------------------------------------C--C---------------------------
---------------------C--C-------C-------C------------------------C-----CC--------------------------------------------
--------------C-----C-C-------CC-CCC-C------------CC----------C---C-C-C--CCCC-----------------C--C-------------------
-------C-C-C-C------------C-CC-----------CCCCC-C----C---CC---------C-C-------CC----CCCBBB---C------------------------
------C-C-C----CC---------B-PBBPBB--C--------------BPB-C-----C--------BBBB------C----------C----C-C------------------
------------C---------------------P-B---------C-------C-----------B-BB-----PB----C--------C--C-----------------------
--------BBPBB-----E----EE------------------------B----PB-----------------------------B---S---------------------------
------------------XXXXXXXX---EE----------S-----------S-----------E-----SE-------------XXXX---------------------------
-----------------SXXXXXXXXXXXXXXXX-ES-XXXXE-------XXXX--------XXXXE---XXXX---E--------XXXX-----ESEEE-----------------
XXXXXX--------XXXXXXXXXXXXXXXXXXXXXXXXXXXXXXXX----XXXX--------XXXXXXXXXXXXXXXX--------XXXX----XXXXXXXXXXXX-----------
