---------------------------------------------------------------------------------------------------------------------
---------------------------------------------------------------------------------------------------------------------
---------------------------------------------------------------------------------------------------------------------
---------------------------------------------------------------------------------------------------------------------
---------------------------------------------------------------------------------------------------------------------
----------CC-----------------------C---------------------------------------C-----------------------------------------
----------------C---------C----C----C-----------C-----CCC------------------------------------------C-----------------
------CC----C--C-C-C--------C-C-CC-------------C-C--------------------C---C-CC--C-C-C---C---------C------------------
------B--BPB--C---C-CC---C---------------C--CCC-----CC---C-C------------C-PB-P--------CC-CCCCC-C-C-------------------
------------------------C----BBP--------C-CC--BPBP----B---------C-C----C------C--------------------------------------
---------------------------------------------B------------C--CCC------BBB---------------B-------C--------------------
------E----EE----------------------EE-------------BPPB------------BBPB-------E------------B-B------------------------
XXXXXXXXXXXXXX---EE----------ES---XXXX---------EE-----E-------------------XXXX-----EE-------------EE-----------------
XXXXXXXXXXXXXXXXXXXXXX-SS-XXXXXXXXXXXX----E---XXXX----XXXX-------------SE-XXXXE---XXXX---S--------XXXXXXXX-----------
XXXXXXXXXXXXXXXXXXXXXXXXXXXXXXXXXXXXXX----XXXXXXXX----XXXX------------XXXXXXXXXXXXXXXXXXXX--------XXXXXXXX-----------
