---------------------------------------------------------------------------------------------------------------------
---------------------------------------------------------------------------------------------------------------------
---------------------------------------------------------------------------------------------------------------------
---------------------------------------------------------------------------------------------------------------------
---------------------------------------------------------------------------------------------------------------------
------C------------------------------------------CC-C-C--C-C--------------C-C-----CC---------------------------------
-------C-C------------C-CC------CC-C----------C-C------C--C------------------C---C--C--------------------------------
--------C------CC------C---CC-CC--------CC-----C------------CCC----------C-----------C----CC------C------------------
--------BBCC--C----C-----------B----CC----C-C-BBB-BPBBBB-------C----C-C-C---------BBBB------C------------------------
---------------------C-------C----------------------------------C-----BB--------------C------CBBB--------------------
-----------BPP----C-C------------------------C--------------------------------------------BB-B-----------------------
------E-----------------------S--------------B-ES-----------S------B-B----------------BBBB---------------------------
XXXXXXXXXX--------------------XXXX-E----------XXXXXXXXXXXXXXXX------------XXXXXXXXXXXX----------------XXXX-----------
XXXXXXXXXX-E----------XXXX---SXXXXXXXX---E----XXXXXXXXXXXXXXXX---E----XXXXXXXXXXXXXXXX--------XXXX----XXXX-----------
XXXXXXXXXXXXXXXXXX----XXXXXXXXXXXXXXXXXXXX----XXXXXXXXXXXXXXXXXXXX----XXXXXXXXXXXXXXXX----XXXXXXXXXXXXXXXX-----------
