-----------------------------------------------------------------------------------------------------
-----------------------------------------------------------------------------------------------------
BBBBBBBBBBBBBBBBBBBBBBBBBBBBBBBBBBBBBBBBBBBBBB-------------------------------------------------------
-----------------------------------------------------------------------------------------------------
-----------------------------------------------------------------------------------------------------
CCCC-CCC---C-C-C-C------------------------------------------------BBBB-------------------------------
-----------------------------------------------------------------------------------------------------
BBBB-BBB-B-B-B-B-B-B-B-------------------------------------------------------------------------------
-B-BCB-BCBCBCBCBCBCBCB---------------------------------BBBBBPP------------E--------------------------
-B-BBB-BBBBBBBBBBBBBBB-------------------E-------------------------------XX------------BB------------
----------------------------------------XX---B----E----------------E-----XX--------------------------
----------------------------------------XX---B---------------------------XX--------------------------
E-E---E-----------------------E---------XX---B-EE---------------E-----E--XX--E-EEE-E---------E-------
XXXXXXXXXXXXXXXXXXXXXXXXXXXXXXXXXXXXXXXXXXXX-XXXXX-XX--XXXXXXXXXXXXXXXXXXXXXXXXXXXXXXXXXXXXXXXXXXXXXX
