--------------------------------------------------------------------------------------------------------------------
--------------------------------------------------------------------------------------------------------------------
--------------------------------------------------------------------------------------------------------------------
--------------------------------------------------------------------------------------------------------------------
--------------------------------------------------------------------------------------------------------------------
---------------BBB-BBBBBB------------------------------------------------B------------------------------------------
--------------------------------------------------------------------------------------------------------------------
--------------------------------------------------------------------------------------------------------------------
--------------------------------------------------------------------------------------------------------------------
------------------------------------P-----------------------------------------------P-------XXX----XX---------------
-----------------------------------------X--------------------------------------------------XX----XX----------------
------------------------------SXX-------SX----------------------------------------------SXXXXXX---XXX---------------
------------------------------EEXCX-----E-X---------------------------------------------EXXXXX-X--XXX---------------
XXXXXXXXXXXXXXXXXXXXXXXXXXXXXXXXXXXXXXXXXXXXXXXXXXXXXXXXXXXXXXXXXXXXXXXXXXXXXXXX--XXXXXXXXXXXXXXXXXXXXXXXXXXXXXXXXXX
