-----------------------------------------------------------------------------------------------------
-----------------------------------------------------------------------------------------------------
-----------------------------------------------------------------------------------------------------
-----------------------------------------------------------------------------------------------------
------------------------------------------------------------C----------------------------------------
---------------------------BBBBBBBBBBB-------BB-------------X------X----------------BB------B--------
-------------------------------------------------------------------X---------------------------------
-------------------------------------------------C-----------------X---------------------------------
X--------------------------BBBBBBBBBBB------------E--------------X-X---------------------------------
X-----------X-----------------------------BBBBBBBBBB--B-------X----X---------------EPB------B---B----
X----------------------------------------------------------P-------X---------------------------------
X--------------------------------------------------E---------------X---------------------------------
X-------E------EE-E----------------------------------E---------XX--X-----E---------------------------
XXXXXXXXXXXX--XXXXXXXXXXX-------------XXXXXXXXXXXXXXXXXXX--XX------XXXXXXXXXXXXXXXXXXXXXXXXXXXXXXXXXX
