---------------------------------------------------------------------------------------------------------------------
---------------------------------------------------------------------------------------------------------------------
---------------------------------------------------------------------------------------------------------------------
---------------------------------------------------------------------------------------------------------------------
---------------------------------------------------------------------------------------------------------------------
----------CC-C-------------------------------------------------------------C-C-----CC--------C-----------------------
--------------C-CC----------------------CC--CC----------CC-------C----------C-----C---C----C-------------------------
-----------------------CC-------------C----C----CC----C--------------C------------------CC--C-C--C-------------------
---------------C--C-CCC--C-C----C--C----------C---------------CCC--CC---C-P---C--C--------BBBP-CC--C-----------------
--------CC-------------BP-C--C-C--C-C---------PBBB--------C--C-----------------C--------------BB---------------------
-------C------------------BBBB-----P-----------------C-------------BBB----------------------------C------------------
-----------EE-----------------PBPB-----------------B--E---------------BB----E------EE----EE--------------------------
XXXXXX----XXXX---EE----ES----------------EE----ES-----XXXX-------E--------XXXX----XXXXXXXXXXXX-EES----XXXX-----------
XXXXXX----XXXXXXXXXXXXXXXX---E-----SE-XXXXXXXXXXXX----XXXX-ES-XXXXE-------XXXX----XXXXXXXXXXXXXXXX----XXXX-----------
XXXXXX----XXXXXXXXXXXXXXXXXXXX----XXXXXXXXXXXXXXXX----XXXXXXXXXXXXXXXX----XXXX----XXXXXXXXXXXXXXXX----XXXX-----------
