--------------------------------------------------------------------------------------------------------------------
--------------------------------------------------------------------------------------------------------------------
--------------------------------------------------------------------------------------------------------------------
--------------------------------------------------------------------------------------------------------------------
--------------------------------------------------------------------------------------------------------------------
--------------------------------------------------------------------------------------------------------------------
--------------------------------------------------------------------------------------------------------------------
--------------------------------------------------------------------------------------------------------------------
--------------------------------------------------------------------------------------------------------------------
--------------------P---B-----------XX--X-X---------------------------------------B------------XX-------------------
---------------------------------XXXXX--XXX-----------------------------------------------XX---XX-------------------
---------------SXX-------------XXXXXXXX-XXX-----------------------------------------------X----XX-------------------
---------------EXX-------C-----XXXXXXXXXXXX---------------------------------------CC-C----E-X-XXXX--X---------------
XXXXXXXXXXXXXXXXXXXXXXXXXXXXXXXXXXXXXXXXXXXXXXXXXXXXXXXXXXXXXXXXXXXXXXXXXXXXXXXXXXXXXXXXXXXXXXXXXXXXXXXXXXXXXXXXXXXX
