-----------------------------------------------------------------------------------------------------
-----------------------------------------------------------------------------------------------------
-----------------------------------------------------------------------------------------------------
-----------------------------------------------------------------------------------------------------
-----------------------------------------------------------------------------------------------------
--------------------------BBB-------------------------X----------------------------------------------
-----------------------------------------------------XX--E-------------------------------------------
--------------------------B------------------------XXXX-XX-------------------------------------------
------------------BBBBBBBB-B------CCCCCCCC--------XXXXX-XX-------------------------------------------
---E------------------------B--------------------XXXXXX-XX-B------------------------BBBB-----------BB
B-XX--------------------------------------------XXXXXXX----------------------------------------------
b-XX-------------------------------------------XXXXXXXX-----------------------------E--------------E-
B-XX---------------E----------E----------------XXXXXXXX---------E--E-----E---------------------------
XXXXXXXXXXXX----XXXXXXXXXXXXXXXXXXXXX--XX------XXXXXXXXXXXXXXXXXXXXXXXXXXXXXXXXXXXXXXXXXXXXXXXXXXXXXX
