--------------------------------------------------------------------------------------------------------------------
--------------------------------------------------------------------------------------------------------------------
--------------------------------------------------------------------------------------------------------------------
--------------------------------------------------------------------------------------------------------------------
--------------------------------------------------------------------------------------------------------------------
-------------------B------------------------------------------------------------------------------------------------
--------------------------------------------------------------------------------------------------------------------
--------------------------------------------------------------------------------------------------------------------
--------------------------------------------------------------------------------------------------------------------
----------------PB------B------------X---XX---------------------------------------------------XX---XX---------------
--------------------------------X---XX---XX--------------------------------------------------XX----XX---------------
--------------------------------X---XX---XX-----------------------------------------------SXXXX---XXX---------------
---------------------C---------EE-XXX---XXX----------------------------------------------XXXXXX---XXX---------------
XXXXXXXXXXXXXXXXXX---XXX---XXXXXXXXXX---XXXXXXXXXXXXXXXXXXXXXXXXXXXXXXXXXXXXXXXXXXXXXXXXXXXXXXXXXXXXXXXXXXXXXXXXXXXX
