---------------------------------------------------------------------------------------------------------------------
---------------------------------------------------------------------------------------------------------------------
---------------------------------------------------------------------------------------------------------------------
---------------------------------------------------------------------------------------------------------------------
---------------------------------------------------------------------------------------------------------------------
------------------C------------------------------------------C--------CCC--CC----------C---C-------------------------
------CC-C-----C-C-C---------------------------------------C-------C-C---CC----C---C---------C--C--------------------
--------C---------------------------------C-C--CC---C----C--C-CC----C-------------C---C---C-C--C-CC------------------
--------PBC--------------C--C---------C-CC----C------CCC----------C---BB-BB---C--C----PB-P----C----C-----------------
-----------CCCPB----------C-----CCC--C-------C---CBBB-------------BBBB---------------B-------------------------------
------------------------------BBB--C--------B-B-PP--------------BB---------------------------------------------------
------S---PB-B----E--------B-B-----------------------------SE----------SS----E-----------ES--------------------------
XXXXXXXXXX-------EXXXX-EE----------------E-----------E----XXXX----E---XXXXXXXXE----EE-XXXXXXXX-EE-SS-----------------
XXXXXXXXXX----XXXXXXXXXXXX-----E------XXXXE----SE-XXXXS---XXXX---EXXXXXXXXXXXXXXXXXXXXXXXXXXXXXXXXXXXX---------------
XXXXXXXXXX----XXXXXXXXXXXX----XXXX----XXXXXXXXXXXXXXXXXXXXXXXXXXXXXXXXXXXXXXXXXXXXXXXXXXXXXXXXXXXXXXXX---------------
