--------------------------------------------------------------------------------------------------------------------
--------------------------------------------------------------------------------------------------------------------
--------------------------------------------------------------------------------------------------------------------
--------------------------------------------------------------------------------------------------------------------
--------------------------------------------------------------------------------------------------------------------
-------------------------------------BBBBBB---------------------------------------------------B---------------------
--------------------------------------------------------------------------------------------------------------------
------------------------------------C-------------------------------------------------------------------------------
--------------------------------------------------------------------------------------------------------------------
-------------------P-BP-----------BBB----------------------------------------BBBPB-----SXX---B----------------------
---------------------------------------------------------------------------------------EEX------XX------------------
-----------------------------SX------------------------------------------SX-------------EX------XX------------------
-----------------------------E-------------------------------------------E--C-C--------EEX------XX------------------
XXXXXXXXXXXXXXXXXXXXXX--XXXXXXXXXXXXXXXXXXXXXXXXXXXXXXXXXXXXXXXXXXXXXXXXXXXXXXXXXXXXXXXXXXXXXXXXXXXXXXXXXXXXXXXXXXXX
