--------------------------------------------------------------------------------------------------------------------
--------------------------------------------------------------------------------------------------------------------
--------------------------------------------------------------------------------------------------------------------
--------------------------------------------------------------------------------------------------------------------
--------------------------------------------------------------------------------------------------------------------
-------------------------------BBBBBBBBBBBB-------------------------------------------------------------------------
--------------------------------------------------------------------------------------------------------------------
------------------------------C-------------------------------------------------------------------------------------
--------------------------------------------------------------------------------------------------------------------
-----------------------------BB----B------------------------------------------------------SXX----X------------------
------------------------------------------------------------------------------------------EEX-X---------------------
------------------------------------------------------------------------------------------EEXXX----X----------------
-----------------X------------C--------CC-C-----------------------------------------C-C---EEXXX---XXX---------------
XXXXXXXXXXXXXXXXXXXXXXXXXXXXXXXXXXXXXXXXXXXXXXXXXXXXXXXXXXXXXXXXXXXXXXXXXXXXXXXXXXXXXXXXXXXXXXXXXXXXXXXXXXXXXXXXXXXX
