-----------------------------------------------------------------------------------------------------
-----------------------------------------------------------------------------------------------------
-----------------------------------------------------------------------------------------------------
-----------------------------------------------------------------------------------------------------
---------------------------------XX------------------------------------------------------------------
BB---------------------------------------------------------------------------------------------------
-----------E----E---E--E-----E-E------------------------------------------CC-------------E-----------
--------XXXXXX-XXXXXXXXXXXXXXXXXX--------------------------------------------------------------------
E----------------------------------------------------------------------------------------------------
BB----------------------------------XX-----BBBBBBB-----------B-----------------------------X---------
------------------------------------XX-----------------------------------------------------XX--------
------------------------------------XX-----------------------------------------------------XX--------
------------------------------------XX-----------------E-----------------------------------XX----E-E-
XXX---------------------------------X---XXXXXXXXXXXXXXXXXXX--XXXXXXXXXXX--XXXXX--XXXXXX----XXXXXXXXXX
