--------------------------------------------------------------------------------------------------------------------
--------------------------------------------------------------------------------------------------------------------
--------------------------------------------------------------------------------------------------------------------
--------------------------------------------------------------------------------------------------------------------
--------------------------------------------------------------------------------------------------------------------
----------------------XB-------------BBBBBB-------------------------------------------------------------------------
--------------------------------------------------------------------------------------------------------------------
------------------------------------C-------------------------------------------------------------------------------
--------------------------------------------------------------------------------------------------------------------
------------------------------------B-----------------------------------------PB-B------SX-----X--------------------
----------------------------------------------------------------------------------------E---XX---XXX----------------
-------------------------------------------------------------------------SXX------------E---XX-XXXXX----------------
-------------------------------------------------------------------------EEXC-C---------E--CXXXXXXXX----------------
XXXXXXXXXXXXXXX-----------------------XXXXXXXXXXXXXXXXXXXXXXXXXXXXXXXXXXXXXXXXXXXXXXXXXXXXXXXXXXXXXXXXXXXXXXXXXXXXXX
