-----------------------------------------------------------------------------------------------------
-----------------------------------------------------------------------------------------------------
------------------------------------C----------------------------------------------------------------
-----------------------------------------------------------------------------------------------------
--------------------XXX----------------------------------------X-------------------------------------
---------------BB-------------------XXXX----------------------------C-------------------------------B
------------------------------------------------------------E-----------CCCCC------------------------
BB--C----------------------------------------------------XXXXXX--------------------------------------
X----------------------------C-----------------------------------CC------------CCCCCC----------E-----
X-BB----------XXXX---------------------XXXXX-------E-----------------X---XXXXX--------B-------XX---B-
X------------XX---------------------------------XXXXXXXXXX------------------------------------XX-----
X--BBB----X-XXX-------------------------------------------------------------------------------XX-----
X---------XXXXX-------------------------------------------------------XXX---------------------XX--EE-
------XXXXXXXXXX---------------XXXXX---------X----------------------------------------XXXXXXXXXXXXXXX
