---------------------------------------------------------------------------------------------------------------------
---------------------------------------------------------------------------------------------------------------------
---------------------------------------------------------------------------------------------------------------------
---------------------------------------------------------------------------------------------------------------------
---------------------------------------------------------------------------------------------------------------------
-------C-C----------C----C--------------------------------C----------------------------------------------------------
------C------------C--CC-------C--C--------------------------C-----------C----C--CC-C-C-------C-C--------------------
-------------C--------------CC------C-----------------CC------------C--CC----C-C-------C---C-------------------------
---------BCC----C----------C--C--C-C------CC--C-CC--C---CC------C----C-----C--P----C--------C------------------------
------------C-------------C----P------C-----C--C--C--C-----------C-C--BBB---C----------------C-----------------------
----------BBBPBP-P----------BB---------CC----C-BB-------------CC---PPB-----B-B------------PBB------------------------
------E-----------E---E-E-------------------BP-------------SE-----------------E----------S-----E-E-------------------
XXXXXXXXXX--------XXXXXXXX----E----SE---------------------XXXX---------SE-----XXXX-EE-XXXX----XXXXEE-----------------
XXXXXXXXXX-EE----SXXXXXXXX---EXXXXXXXX---------EE----EE---XXXX----E---XXXX---EXXXXXXXXXXXXE---XXXXXXXX---------------
XXXXXXXXXXXXXXXXXXXXXXXXXXXXXXXXXXXXXX--------XXXXXXXXXXXXXXXX----XXXXXXXXXXXXXXXXXXXXXXXXXXXXXXXXXXXXXXXX-----------
