-----------------------------------------------------------------------------------------------------
-----------------------------------------------------------------------------------------------------
BBBBBBBBBBBBBBBBBBBBBBBBBBBBBBBBBBBBBBBBBBBBBBBBBBBBBBBBBBBBBBBBBBBBBBBBBBBBBBBBBBBBBBBBBBBBB--------
BBBBBBBBBBBBBB----------------------BBB--------------------------------------------------------------
BBBBBBBBBBBBBB----------------------BBB--------------------------------------------------------------
BBBBBBBBBBBBBB----------BBBBBBBB-----BB--------------------------------------------------------------
-------------------------------------BB--------------------------------------------------------------
-------------------------------------BB--------------------------------------------------------------
CCCCCC----P--------------------------BB-----------E-----------------------------E-------------CCC----
BBBBBB-BBBPPBB----------BBBBBBBB-----BB--E-------XX--------E-------------E-----XX-----BBB-BBB--------
-------BB---BB------E-------------------XX-------XX-------XX---E--------XX-----XX--E-----------------
-------BB---BB-----XX-------------------XX-------XX-------XX--XX--------XX-----XX-XX-----------------
---------CCCBB-----XX-E---------------E-XX----E--XX-------XX--XX-E------XX---E-XX-XX----EE-----------
XXXXXXXXXXXXXXXX-XXXXXXXXXXXXXXXXXXXXXXXXXXXXXXXXXXXXXXXXXXXXXXXXXX-XXXXXXXXXXXXXXXXXXXXXXXXX-----XXX
