-----------------------------------------------------------------------------------------------------
-----------------------------------------------------------------------------------------------------
BBBBBBBBBBBBBBBBBBBBBBBBB----------------------------------------------------------------------------
-----------------------------------------------------------------------------------------------------
--------------------------CC--------------------------------------------X--E-----CC-----------XX--CCC
----------------E--E--E----------------------------------E-----------------E-------------------------
---------------XX-XX-XX------------------------------XXXXXXXXXXX-------------------------------------
-B-------------XX-XX-XX--------------------------------------------------------------------XXX-------
CB-------------XX-XX-XX----------CCCCC---------XBB---------------------------------------------------
BB--------XX---XXBXXBXXBB---------------------XXX----------------BBB--------------XXXXX--------------
---------EXX---XX-XX-XX-----------------------XXX-----------------------X---------------XXXX---------
--------XXXX---XX-XX-XX----XXXXX--------------XXX-----X----------------------E-----------------------
---E--XXXXXX-E-XX-XX-XX----------------------EXXX----------------------------------------------------
XXXXXXXXXXXXXXXXXXXXXXXXX---------XXXXXXXXXXXXXX-----------------XXXX--------X--------------------XXX
