---------------------------------------------------------------------------------------------------------------------
---------------------------------------------------------------------------------------------------------------------
---------------------------------------------------------------------------------------------------------------------
---------------------------------------------------------------------------------------------------------------------
---------------------------------------------------------------------------------------------------------------------
-------C------------------------------------------------------C---------C---------------------CC-C-------------------
--------C---C-C--C---------------C----CC-C----CCC-----------------C------C-----C-------------C-----------------------
------C--C-C-C--C---------------------------C-----C----C---C---CC------C------------------C--------------------------
------BBBBBBBB--------C-C----C--C----C--C-C--------C-CC------C------C-PB------C----C-----C----B----C-----------------
-------------------C---C------BB--CCC----B---CPBPP--C---CC--C-----BBPB-----C-C----C-CC----BBB------------------------
---------------------C-----C---------------BBB----P-----------------------C-----------CC-----------------------------
------S----EE--------------P-B-----------------------------------E-----SE---------------PP-----SE--------------------
XXXXXXXXXXXXXX---E------------E---------S------ES-------------XXXXE---XXXX----E-----------E---XXXX-------------------
XXXXXXXXXXXXXXXXXX-----EE-----XXXX----XXXXE---XXXX---EE----EE-XXXXXXXXXXXX----XXXX--------XXXXXXXX-------------------
XXXXXXXXXXXXXXXXXX----XXXX----XXXX----XXXXXXXXXXXXXXXXXXXXXXXXXXXXXXXXXXXX----XXXX--------XXXXXXXX----XXXX-----------
