---------------------------------------------------------------------------------------------------------------------
---------------------------------------------------------------------------------------------------------------------
---------------------------------------------------------------------------------------------------------------------
---------------------------------------------------------------------------------------------------------------------
---------------------------------------------------------------------------------------------------------------------
-------------------------C-----C--------------------------C-C-------------------------------------C------------------
------------------------C-----C-----------------------------------C----C---------C-----------------C-----------------
----------C------C-C-C-C--------CC---------CC---C------------C-----C-----------CC-------CC---------------------------
--------C-----CC--C-C------C--BB-P----------------CC-C--------C-----C----C---------C-CCC-------C---------------------
------CC-----CPBB-----------C-----CC---------C--BB--C----------C-C-P-B------CC--------P--B----C-CC-------------------
---------BBBPB---------------------------C---------------C------C----------C--------C------C-------------------------
-----------------------ES-PBP-S-------------------PPP------EE-------------BBP-S-----------BB------S------------------
-----------------ES---XXXX----XXXX-------------EE---------XXXX----S----EE-----XXXX-------S--------XXXX---------------
------E----SE-XXXXXXXXXXXX----XXXX-SS-----S---XXXX--------XXXX----XXXXXXXX----XXXX----XXXX-----SESXXXX---------------
XXXXXXXXXXXXXXXXXXXXXXXXXX----XXXXXXXX----XXXXXXXX--------XXXX----XXXXXXXX----XXXX----XXXX----XXXXXXXXXXXX-----------
