-----------------------------------------------------------------------------------------------------
-----------------------------------------------------------------------------------------------------
BBBBBBBBBBBBBBBBB------------------------------------------------------------------------------------
BB---------------------------------------------------------------------------CC----------------------
BB-----------------------E---------------------------------------------------------------------------
BB-----------------------E------------------------------------------------X----X------BBB------------
BB-----------C-----------------X-----------------------------------------XX--------------------------
BB----------------------------------------------------------------------XXX-----------B--------------
BB----------B------------------------------------CC---------------------XXX------BBBBB-B-------------
BB---------------------E---------------X------BB------------------------XXX-------------B------------
-----E---XXX--XXXX----XX------------E-XX-------------------------------XXXX--------------------------
----XX--XXXX--XXXX----XX-----------XX-XX--------------------------XX--XXXXX--------------------------
-E--XX--XXXXE-XXXX----XX----XX-----XX-XX----------------EE--------XXXXXXXXX-------------------------X
XXXXXXXXXXXXXXXXXXXXXXXX---------XXXXXXXXXXXXXXXXXXXXXXXXXXXXXXXXXXXXXXXXXXX----XXXXXXXXXXXXXXXXXXX--
