---------------------------------------------------------------------------------------------------------------------
---------------------------------------------------------------------------------------------------------------------
---------------------------------------------------------------------------------------------------------------------
---------------------------------------------------------------------------------------------------------------------
---------------------------------------------------------------------------------------------------------------------
-----------C-----------------------------------------------------------------C----------C----------------------------
----------C-------------------------------C-C----------------C----------C--C-----C-------C---------------------------
-------C-C---C----------------C--C--CC---C---------------------C--C---C-----C---------CC--C-C------C-----------------
----------BB----CC-------CC-----C--C--CCC--C---C-------CC--------C-C-------PP-C------C--BB------C--------------------
------------------CCC---------BPBP--------------CCBBBP---C---------------B--------C----------C-C---------------------
------PBBB----CC-----C--C---C-----P-B----------P-P---------------------------------C------B-BB-----------------------
-----------SS-------------B-BB------------------------B----------------------E-----------E--------ES-----------------
----------XXXX----------------E----------SE----------E-----EE----E-----EE-XXXXS-------XXXX--------XXXXXXXX-----------
------E---XXXX----------------XXXX-ES-XXXXXXXX-EE-XXXX----XXXXXXXXS---XXXXXXXXXXXX----XXXXE-------XXXXXXXX-----------
XXXXXXXXXXXXXX----------------XXXXXXXXXXXXXXXXXXXXXXXX----XXXXXXXXXXXXXXXXXXXXXXXX----XXXXXXXX----XXXXXXXX-----------
