--------------------------------------------------------------------------------------------------------------------
--------------------------------------------------------------------------------------------------------------------
--------------------------------------------------------------------------------------------------------------------
--------------------------------------------------------------------------------------------------------------------
--------------------------------------------------------------------------------------------------------------------
---------------BB---BBBB--------------------------------------------------------------------------------------------
--------------------------------------------------------------------------------------------------------------------
--------------------------------------------------------------------------------------------------------------------
--------------------------------------------------------------------------------------------------------------------
-----------------------------------XXX--XXX-------------------------------------------------------------------------
----------------------------------XXXX--XX--------------------------------------------------------------------------
------------------------------SXXXXXX---XXX-------------------------------------------------------------------------
------------------------------EXXXXX-X-XXXX-------------------------------------------------------------------------
XXXXXXXXXXXXXXXXXXXXX---XXX---XXXXXXXXXXXXXXXXXXXXXXXXXXXXXXXXXXXXXXXXXXXXXXXXX---XXPX--XXXXXX--XXXXXXXXXXXXXXXXXXXX
