--------------------------------------------------------------------------------------------------------------------
--------------------------------------------------------------------------------------------------------------------
--------------------------------------------------------------------------------------------------------------------
--------------------------------------------------------------------------------------------------------------------
--------------------------------------------------------------------------------------------------------------------
----------------BBBBBBBBP---------------------------------------------------BB--------------------------------------
--------------------------------------------------------------------------------------------------------------------
--------------------------------------------------------------------------------------------------------------------
--------------------------------------------------------------------------------------------------------------------
-------------------BB-----P---------X----------------------------------------BPB--------SX--------------------------
-----------------------------------XX---XX---------------------------------------------EE--------X------------------
------------------------------SXX-XXX--XXX---------------------------------------------EE-------XX------------------
------------------------------E-X-XX---XXX-------------------------------EX-C-C---C--C--E--C----XX------------------
XXXXXXXXXXXXXXXXXXXXXXXXXXXXXXXXXXXXXXXXXXXXXXXXXXXXXXXXXXXXXXXXXXXXXXXXXXXXXXXXXXXXXXXXXXXXXXXXXXXXXXXXXXXXXXXXXXXX
