---------------------------------------------------------------------------------------------------------------------
---------------------------------------------------------------------------------------------------------------------
---------------------------------------------------------------------------------------------------------------------
---------------------------------------------------------------------------------------------------------------------
---------------------------------------------------------------------------------------------------------------------
----------------------------------------------------C--------------C-----------------------C-------------------------
-----------C----------------------CC---C---CC-----C----C-------------------C--------------C-CC-----------------------
----------C--C-C---C-------------C-----------CC--C---CC-CC--------C-------C-C--------C--CC----CC---------------------
----------BB--C-----C--C--C-CCBBB--------CC-----C-B-B-P---C-----CCB--B-------C--CC-C--C-----------CC-----------------
-----------------CC---C-C--C--------------B-BB-------------------------C-CB---CC--C-C-BBBB---------------------------
------C-C----------------C---------------------BPP------------C---------C------------B-------------------------------
------B-B--SE--------------BBBS----------------------SS-----------E---BPBB----------------E--------------------------
XXXXXX----XXXX----------------XXXX-EE----EE-------XXXXXXXX--------XXXX-------S-----------EXXXX-SS--------------------
XXXXXX----XXXX---ES-----------XXXXXXXXXXXXXXXX-SS-XXXXXXXX--------XXXX----XXXX-----EE-XXXXXXXXXXXX-------------------
XXXXXX----XXXXXXXXXXXX--------XXXXXXXXXXXXXXXXXXXXXXXXXXXX--------XXXX----XXXX----XXXXXXXXXXXXXXXX----XXXX-----------
