--------------------------------------------------------------------------------------------------------------------
--------------------------------------------------------------------------------------------------------------------
--------------------------------------------------------------------------------------------------------------------
------------------------X-------------------------------------------------------------------------------------------
--------------------------------------------------------------------------------------------------------------------
--------------------------------BBBBBPB-BBB-------------------------------------------------------------------------
--------------------------------------------------------------------------------------------------------------------
--------------------------------------------------------------------------------------------------------------------
--------------------------------------------------------------------------------------------------------------------
-----------------------------BB----B------B---------------------------------------------------XX---XX---------------
----------------------------------------------------------------------------------------------XX---XX---------------
---------------------------------------------------------------------------------------------XXX---XX---------------
--------------------------C-C-C--------C----------------------------------------------------XXXX--XXX---------------
XXXXXXXXXXXXXXXXXXXXXXXXXXXXXXXXXXXXXXXXXXXXXXXXXXXXXXXXXXXXXXXXXXXXXXXXXXXXXXXX--XXP----XXXXXX--XXXXXXXXXXXXXXXXXXX
