---------------------------------------------------------------------------------------------------------------------
---------------------------------------------------------------------------------------------------------------------
---------------------------------------------------------------------------------------------------------------------
---------------------------------------------------------------------------------------------------------------------
---------------------------------------------------------------------------------------------------------------------
---------------------------C---------------------------------C---------------C---------------------------------------
-------C-------------------------------C-------------C-CC--C--------------CC-----------------------------------------
----------------C-----------CC----CC------------------C---C-----C--------C--C-----C-------C-C-CC-C-------------------
--------BBC-------CCCC--CC-BB--------C--CC---------------C-------C----C-C-------C---CC--CC-C-C-----------------------
-------------CC--C-----C------C-----C-----C---CC--BPB--B------C--------C-------C---C---B--P-B------------------------
----------------------C--------C------------CCP--B-------------B-B-C---B-----------------------B---------------------
------S-----------------PB---S---------------B-------------SE-----B-P--------S--------------------E------------------
XXXXXXXXXX--------S-------XXXX-----------E-----------SE---XXXX------------XXXX-----------EE-------XXXX---------------
XXXXXXXXXX-------EXXXX----XXXX-----SS-XXXX-----EE-XXXXXXXXXXXX---E-----S-SXXXX-----SE-XXXXXXXX-E--XXXX---------------
XXXXXXXXXX----XXXXXXXX----XXXX----XXXXXXXX----XXXXXXXXXXXXXXXXXXXX----XXXXXXXX----XXXXXXXXXXXXXXXXXXXX---------------
