-----------------------------------------------------------------------------------------------------
-----------------------------------------------------------------------------------------------------
---------------------------------------------------------------------------------------BBBB----------
-----------------------------------------------------------------------------------------------------
-------------CC-------------------------------------------------------------------------P------------
-----------------------BB--------------------------------------------------------------BPP-----------
------------------------------------C-C-C------------------------------------------------------------
-----------------------------------XXXXXXX-----------------------------------------------------------
-E---------------------------------------------------------------------E----------------------------E
XX------B-------------BBB---------------------------------------------XX---------------BBBB--------XX
--------------------------------------------------------------E-------XX---------------------------XX
--------------XX---------------------------------------------XX-------XX-------------E-------------XX
------------------EE-----EE----------------------------E-----XX--E----XX---------------------------XX
XXXXXXXXXXX------XXXXXXXXXXXXXX----XXXXXXXXXXX-XXXXXXXXXXXXXXXXXXXXXXXXXXXXXXXXXX----X-XXXX----XXXXXX
