--------------------------------------------------------------------------------------------------------------------
--------------------------------------------------------------------------------------------------------------------
--------------------------------------------------------------------------------------------------------------------
--------------------------------------------------------------------------------------------------------------------
--------------------------------------------------------------------------------------------------------------------
-------------------B--------------------------------------------------------BB----------------BBB-------------------
--------------------------------------------------------------------------------------------------------------------
--------------------------------------------------------------------------------------------------------------------
--------------------------------------------------------------------------------------------------------------------
------------------------B--P---------XXX----------------------------------BB--------------SXX----X------------------
------------------------------------XX----------------------------------------------------EEX---X-------------------
--------------------------------SX-XXX--XXX-----------------------------------------------EEX---XX------------------
-------------------------C-C---E-XXXX---XXX-----------------------------------------C-----EEX-X-XX------------------
XXXXXXXXXXXXXXXXXXXXXXXXXXXXXXXXXXXXXXXXXXXXXXXXXXXXXXXXXXXXXXXXXXXXXXXXXXXXXXXXXXXXXXXXXXXXXXXXXXXXXXXXXXXXXXXXXXXX
