-----------------------------------------------------------------------------------------------------
-----------------------------------------------------------------------------------------------------
--------E--------------------------------------------------------------------------------------------
-----------------------------------------------------------------------------------------------------
------------------------------------------------------------------E----------------------------------
----------------------------------CC----C---------C--E------------E----------------------------------
E----------------------------------------------XXXXXXXXXXXX------------------------------------------
X--------------------------------------------X-------------------------------------------------------
X-------------------------------------------------------------C-------------------------------------X
X---------------B----------------X--XXXX-XXXX----------------------------------B--B-----------------X
X---------------------------------------------------------------------------------------------------X
X-------------------------------------------XXXX----------------------------------------------------X
X-------XX--------------X------------------------------------------------------E-----E----------EE--X
XXXXXXXXXXXXXXXXXXXXXXXXXXXXXXXX------------------------------------XXXXXXXXXXXXXXXXXXXXXXXXXXXXXXXXX
