-----------------------------------------------------------------------------------------------------
-----------------------------------------------------------------------------------------------------
-----------------------------------------------------------------------------------------------------
-----------------------------------------------------------------------------------------------------
-----------------------------------------------------------------------------------------------------
---------------------------------BBB----------------E----------------------BBB-B---------------------
X--------------------------BB------------------------------------------------------------------------
------X----------------------------------------------------------------------------------------------
--------------C-----------------------------------------------------------B---E----------------------
----------E--------------E------XXXXX-----------------XXXX--------E----------------------------------
---------XX-------------XX---XXXXX-------------------------------XX----------------------------------
XXX------XX-------------XX--XXXX----------X----------------------XX----------------------------------
-------E-XX-E-----------XX-XXXX-----------X---EE---CCC---------E-XX----------------------------------
------XXXXXXXXXXXXXXXXXXXX-XXX----X-------XXXXXXXX-XXX-----XXXXXXXXXXXXXXXXX-------XXXXXXXXXXXXXXXXXX
