-----------------------------------------------------------------------------------------------------
-----------------------------------------------------------------------------------------------------
-----------------------------------------------------------------------------------------------------
-----------------------------------------------------------------------------------------------------
-----------------------------------------------------------------------------------------------------
------------------------------BBB--------------------B--BBBBBB---------------------------------------
-----------------------------------E-----------------------------------------------------------------
XXXXX------------------------------------------------------------------------------------------------
---------------------E-------------------------E-----------------E-----------------------------------
--------------------XX-------XXXXX------------XX-----B----------XX-----------------------------------
X-------------------XX----XXXXX---------------XX---------E------XX-----------------------------------
--------------------XX--XXXXX-----------------XX--------XX------XX--------------E--------------------
--------------------XX-XXXX----------------E--XX--------XX-E----XX--------------------------EE--EEEE-
------XXXXXXXXXXXXXXXXXXX------XXX---XXXXXXXXXXXXXXXXXXXXXXXXXXXXX-XXX--XXXXXXXXXXXXXXXXXXXXXXXXXXXXX
