---------------------------------------------------------------------------------------------------------------------
---------------------------------------------------------------------------------------------------------------------
---------------------------------------------------------------------------------------------------------------------
---------------------------------------------------------------------------------------------------------------------
---------------------------------------------------------------------------------------------------------------------
------------------------------C--------------------------------------------------------------------------------------
--------------------------------C-----C---------------------------------------CCC--C-----------C---------------------
-----------C--------------CC---C-CCC-C-C---------------------------CC------------C---------------C-------------------
--------C-C---C--------C-------P----C--------------C--C--CC-----C-----------------C--C--CC-C-C-----------------------
---------C--CC-C------C--------------------C--C---B-B--C---C---C--PBBBC-C-C-CC---------C--C-C-----C------------------
----------B-B-BB---C----C-BBBB---------------C-CC-------C-----C-----------------------C------P-----------------------
-----------------------BPB----S--------------BPPBP------------B-PP------------E---------BB---------------------------
------------------------------XXXX-SE----E----------S-------------E-----------XXXX-EE----------EE--------------------
------E----ES----E-----------EXXXXXXXXXXXX--------XXXX------------XXXX-------EXXXXXXXX----E---XXXX----XXXX-----------
XXXXXXXXXXXXXXXXXX--------XXXXXXXXXXXXXXXX--------XXXX------------XXXX----XXXXXXXXXXXX----XXXXXXXX----XXXX-----------
