---------------------------------------------------------------------------------------------------------------------
---------------------------------------------------------------------------------------------------------------------
---------------------------------------------------------------------------------------------------------------------
---------------------------------------------------------------------------------------------------------------------
---------------------------------------------------------------------------------------------------------------------
------------C-----------------CC--------------------------------------C--C--C----------------------------------------
-------------CC------C-----------------------------C--C--C------C----------C---C-C---------C-------------------------
-----------------CC-------C-----CC------C--C-C----------C-----------------C--CC-C----C----C--C-C---------------------
------CCC-B-BB------C-C-C--C-C----C----C----------C-CCB-B---C-CC------BP----------CC--B-BPPBB-----C------------------
--------------BB------------C-------CC--------C-C-BBBB------------C-C---------------C-----------CC-C-----------------
-----------------------C--B-----------------B----------------------C---------------B-B-------------------------------
--------P--ES----------B-P----E----------------BB-----S------------BBB-EE----SE----------EE--------------------------
XXXXXX----XXXX---ES-----------XXXX-------------------EXXXX-------E----XXXXXXXXXXXX----XXXXXXXX--------XXXX-----------
XXXXXX----XXXXXXXXXXXX-------EXXXX-SE----ES-------XXXXXXXX----XXXX----XXXXXXXXXXXX-EE-XXXXXXXX-EES----XXXX-----------
XXXXXX----XXXXXXXXXXXX----XXXXXXXXXXXXXXXXXXXX----XXXXXXXX----XXXX----XXXXXXXXXXXXXXXXXXXXXXXXXXXX----XXXX-----------
