--------------------------------------------------------------------------------------------------------------------
--------------------------------------------------------------------------------------------------------------------
--------------------------------------------------------------------------------------------------------------------
--------------------------------------------------------------------------------XX----------------------------------
---------------------------------------------------------------------------------X----------------------------------
--------------------------------------BBBBB---------------------------------BBBBBBPB--------------------------------
--------------------------------------------------------------------------------------------------------------------
--------------------------------------------------------------------------------------------------------------------
--------------------------------------------------------------------------------------------------------------------
----------------------------------BPB-------------------------------------P-----------------------------------------
------------------------------SX------------------------------------------------------------------------------------
-----------------------------SEX----------------------------------------------------------XX------------------------
-------------------------C---EEX----------------------------------------------------------XX------------------------
XXXXXXXXXXXXXXXXXXXXXXXXXXXXXXXXXXXXXXXXXXXXXXXXXXXXXXXXXXXXXXXXXXXXXXXXXXXXXXXXX---XXXXXXXXXXXXXXXXXXXXXXXXXXXXXXXX
