---------------------------------------------------------------------------------------------------------------------
---------------------------------------------------------------------------------------------------------------------
---------------------------------------------------------------------------------------------------------------------
---------------------------------------------------------------------------------------------------------------------
---------------------------------------------------------------------------------------------------------------------
------------------------------------------CCC-----------------------------------------------C------C-----------------
------------C-------------C-C---------------------------------------------------C--------------C--C------------------
---------------------------C----------C-----------------------------C-----C---C--C---------C-C--CC-------------------
------CCC------C---C-----C---C---------------B----CCCC------C------C---C-C---C-----C---C---BP-C----------------------
---------CBB-P----C-C-CCC-BBPB-C---C-----------CCCPBB-CC-----C----BBPP--C--CC--------C--C----------------------------
--------------C-C-------------C-C---C---------BPBB--------------C-----BBPBB---------C-C------------------------------
-------------------------B----BB---------E-E--------------------BP------------E-----BBB-B-E-------SE-----------------
-----------SS----------------E--------XXXXXXXX-------E------------E-----------XXXX--------XXXX-EE-XXXX---------------
XXXXXX----XXXX----E-------XXXX--------XXXXXXXX-EE-XXXXE----EE-----XXXX-EE----EXXXX--------XXXXXXXXXXXX---------------
XXXXXX----XXXX----XXXX----XXXX--------XXXXXXXXXXXXXXXXXXXXXXXX----XXXXXXXXXXXXXXXX--------XXXXXXXXXXXX---------------
