-----------------------------------------------------------------------------------------------------
-----------------------------------------------------------------------------------------------------
BBBBBBBBBBBBBB--------------------------------CC-----------------------------------------------------
----------------------------------------------XXX---------------------------------------C------------
-----------------------------C----------------------------------------------XXXXX--------------------
--------------------------------------------------------------------------------------BBB------------
------------C----------------------------------------------------------------------------------------
------------------------------------------------------XXXX-------------------------------------------
-----------B----------------------------E--------------------E--------------------XX-----------------
-XXX-----------------------------------XX-------------------XX------------E-----------BB------------X
EXXX------X--XX-------E----------E-----XX-----XXXXXXXXX-----XX--E--------XX------------------E------X
XXXX-----XX--XX-----------------XX-----XX-------------------XX-------X---XX---------------------B---X
XXXX--E-XXXE-XX--------------E--XX-----XX-------------------XX-------X---XX-------------E-------b---X
XXXXXXXXXXXXXX--XXXXXX-XXXXXXXXXXXXXXXXXXX-XX--------------XXXXXXXXXXXXXXXX---------XXXXXXXXXXXXXXXXX
