--------------------------------------------------------------------------------------------------------------------
--------------------------------------------------------------------------------------------------------------------
--------------------------------------------------------------------------------------------------------------------
--------------------------------------------------------------------------------------------------------------------
--------------------------------------------------------------------------------------------------------------------
---------------B-----BBB-----------------------------------------------------BBP------------------------------------
--------------------------------------------------------------------------------------------------------------------
--------------------------------------------------------------------------------------------------------------------
--------------------------------------------------------------------------------------------------------------------
--------------------------P--P----B-B----------------------------------------BBBP------------XX--X------------------
--------------------------------------------------------------------------------------------XXX--XX-----------------
----------------------------------------------------------------------------------------SXX-XXX--XXX----------------
--------------------------------------------------------------------------C-------------E-XXXXXX-XXX----------------
XXXXXXXXXXXXXXXXXXXXXX---XXXXXXXXXXXXXXXXXXXXXXXXXXXXXXXXXXXXXXXXXXXXXXXXXXXXXXXXXXXXXXXXXXXXXXXXXXXXXXXXXXXXXXXXXXX
