-----------------------------------------------------------------------------------------------------
-----------------------------------------------------------------------------------------------------
-----------------------------------------------------------------------------------------------------
-----------------------------------------------------------------------------------------------------
-----------------------------------------------------------------------------------------------------
------------------------------------------------------------------------------------------------X----
BB---C---------------------------------------CCC-----------XX---------------C-C-C-C------------------
-------------------E-------------------------------------------------------XXXXXXXXX-----------------
------------------XX-------------------E-------------------------------------------------------------
--------------BB--XX------------------XX------XXXXXXXXXXXX-------------------------------------X-----
-BB---------------XX------------------XX-------------------------------------------------------------
------------------XX------B---B-------XX-------------------------------------------------------------
----XXXX----------XX------b---b-------XX-XXXXX----------------------------E---------E-------------EEE
XX---------XXXXXXXXXXXXXXXXXXXXXXXXXXXXX--------------------XXXXXXXXXXXXXXXXXXXXXXXXXXXXXXXXX---XXXXX
