---------------------------------------------------------------------------------------------------------------------
---------------------------------------------------------------------------------------------------------------------
---------------------------------------------------------------------------------------------------------------------
---------------------------------------------------------------------------------------------------------------------
---------------------------------------------------------------------------------------------------------------------
-------------------C-------C-------C-------------------------------------------C-C-------C---------------------------
---------------C--C--C-------C------C-C------------------------------------------------------------------------------
--------------C-CC--------C------C---C-C--C---------------------CC--------------C-----C--------C---------------------
-------C--C-CCPBP-----C-----PB----BP----CC--CC-C---CCCC-C-CC-CCC---------C---------C---B------C-C-C------------------
------C-CC-C-----------C------B--B---------C--C------------------B-C------C-C-------C------C-C---C-------------------
----------BBBB----------C-----------------------CC----------------C-CC--C---------C-------C--------------------------
------PB-B-------EE----------S-----EE-----------PB--B-------------PBP-PB-B----E----------SBB-------------------------
--------------XXXXXXXX----XXXXE---XXXX---S-----------------------E------------XXXX----XXXX--------SE-----------------
-----------EE-XXXXXXXX----XXXXXXXXXXXXXXXXE----------------SE-XXXX------------XXXX----XXXX-----ESSXXXX---------------
XXXXXX----XXXXXXXXXXXX----XXXXXXXXXXXXXXXXXXXX------------XXXXXXXX------------XXXX----XXXX----XXXXXXXX---------------
