---------------------------------------------------------------------------------------------------------------------
---------------------------------------------------------------------------------------------------------------------
---------------------------------------------------------------------------------------------------------------------
---------------------------------------------------------------------------------------------------------------------
---------------------------------------------------------------------------------------------------------------------
---------------CC--------------------------------------------------------------------C-------------------------------
-------------CC-----------------C--------C--------------------C--C---C--C---------C-C----C---------------------------
----------C------C-----C-------C-CC-C-CC-------C-----C-C--------------C---------------CC---CC-----CC-----------------
--------CC--C-----CC--C----C-CBBB---------CC--C-C----------C---C--CC-----C-C-C-------BBPBB---C-CC--------------------
------CC--BP------------C-C-C------C-C------CC---CBBPB----C--C-------BBB-B-------C--------BB--C--C-------------------
--------BB----------CC---BBB-B----------------B---------------------------C-C----------------------------------------
-----------------E------------E----------E--P---------E-------------------BBB------ES----E--------SE-----------------
-----------ES-XXXX------------XXXX----XXXX----------S-XXXX-------SE----EE---------XXXXXXXXE-------XXXX---------------
------S---XXXXXXXX-----EE----SXXXX-SE-XXXX-----SE-XXXXXXXX-SS-XXXXXXXXXXXX----S---XXXXXXXXXXXX-SESXXXX---------------
XXXXXXXXXXXXXXXXXX----XXXXXXXXXXXXXXXXXXXX----XXXXXXXXXXXXXXXXXXXXXXXXXXXX----XXXXXXXXXXXXXXXXXXXXXXXXXXXX-----------
