--------------------------------------------------------------------------------------------------------------------
--------------------------------------------------------------------------------------------------------------------
--------------------------------------------------------------------------------------------------------------------
--------------------------------------------------------------------------------------------------------------------
--------------------------------------------------------------------------------------------------------------------
-------------------------------------------------------------------------B----BBB-----------------------------------
--------------------------------------------------------------------------------------------------------------------
--------------------------------------------------------------------------------------------------------------------
--------------------------------------------------------------------------------------------------------------------
-------------------BPB-------SX----B-BB--------------------------------------BB-P-----------X----XX-----------------
-----------------------------E--------------------------------------------------------------XX--XXX-----------------
-----------------------------E----------------------------------------------------------SXX-XX-XXXX-----------------
----------------X-C-C---C--C-------------C----------------------------------------------EEXCXXXXXXX-----------------
XXXXXXXXXXXXXXXXXXXXXXXXXXXXXXXXXXXXXXXXXXXXXXXXXXXXXXXXXXXXXXXXXXXXXXXXXXXXXXXXXXXXXXXXXXXXXXXXXXXXXXXXXXXXXXXXXXXX
