---------------------------------------------------------------------------------------------------------------------
---------------------------------------------------------------------------------------------------------------------
---------------------------------------------------------------------------------------------------------------------
---------------------------------------------------------------------------------------------------------------------
---------------------------------------------------------------------------------------------------------------------
------------------------------------------------C----------------------CC--------------------------------------------
------C--C--C------C-C--------------------C----C----CC---C---------C------C-C------C---------------------------------
-------------C--CCC------C-C-C--C-CCC--CCC---C----C---CCC-CC----CCC---C----C--CC-------------------------------------
-------CC-PPB--C-------C----C--------------CC-PPBB-C----------CC-------PB-----------CC-CCC-C-C-----C-----------------
--------PB------------C-C-C---BBBB-----------P----BBB-------CC-----BP-----BPB-----------BP---------------------------
------------------------BBBBBB------------------------------------------------------------C-C-CC-CC------------------
-----------EE----------------------------------SE----------------------SE-----------------BPB------------------------
------S---XXXX----E-----------S-----------E---XXXX---SE----------ES---XXXX---ES----EE----S---------------------------
XXXXXXXXXXXXXX---EXXXX-ES----EXXXX-EE----SXXXXXXXXXXXXXXXX-ES-XXXXXXXXXXXXXXXXXXXXXXXXXXXX------------XXXX-----------
XXXXXXXXXXXXXXXXXXXXXXXXXXXXXXXXXXXXXXXXXXXXXXXXXXXXXXXXXXXXXXXXXXXXXXXXXXXXXXXXXXXXXXXXXX------------XXXX-----------
