-----------------------------------------------------------------------------------------------------
-----------------------------------------------------------------------------------------------------
-----------------------------------------C-----------------------------------------------------------
----------------------------------------XXX--------------------------------------C-------------------
-----------------------------CC----------------------------------------------------------------------
X-------------------------------------------------------------------------B---BBBB-------------------
------------------------------------E----------------------------------------------------------------
---------------------------------XXXXX---------------------------------------------------------------
-----------------------------------------------------------------------------------------------------
XXXX--------------------------XXX----CCC----------------------------------P---BBB------------B-------
------------------E--------------------E-----------------------------X-------------------------------
-----------------XX-------------XXXXXXXXX---------------------------XX-------------------------------
-------E---------XX-----------------------------------E-----------XXXX-----------E--EE-----E---------
---X-XXXXXXXXXXXXXXXXXXXXXXX-----------------XXXXXXXXXXXXXXXXXXXXXXXXXXXXXXXXXXXXXXXXXXXXXXXXXXXXXXXX
