---------------------------------------------------------------------------------------------------------------------
---------------------------------------------------------------------------------------------------------------------
---------------------------------------------------------------------------------------------------------------------
---------------------------------------------------------------------------------------------------------------------
---------------------------------------------------------------------------------------------------------------------
------------------C------------------------CC----------------C----------C----------------------C---------------------
------------CC-----------C------------C------C-------------C-------------------C-C-----------------------------------
--------------------C-----CC-C----CC----C-C-------------C---C--CC------C-------------C------C-C-CC-------------------
-------------B--CC-----C-------CC------C-----BC---PBPBCC------C-------PBBBC---------C-C-CCC-------CC-----------------
------C-------C---------------------CC-------------------C---------C---------------C---------C-----------------------
-------CC-----P-----------P--BBBB-B-------------CC----B--------BB-C--C------CC-------B-C--B--------------------------
-----------SE-----S-----------------------E-----P----E-----SE-----BBPB-ES--P----------PBBB-----EEE-------------------
XXXXXX----XXXX----XXXX-SE----------------SXXXX----XXXX----XXXX--------XXXX----S---------------XXXX-------------------
XXXXXX----XXXX--S-XXXXXXXX---EE----SS-XXXXXXXX----XXXXE---XXXX---E----XXXX----XXXX-SS-----E---XXXXEE--XXXX-----------
XXXXXX----XXXXXXXXXXXXXXXXXXXXXXXXXXXXXXXXXXXX----XXXXXXXXXXXXXXXX----XXXX----XXXXXXXX----XXXXXXXXXXXXXXXX-----------
