-----------------------------------------------------------------------------------------------------
-----------------------------------------------------------------------------------------------------
BBBBBB------------------E----------------------------------------------------------------------------
-----------------------------------------------------------------------------------E--E--------------
----------------------------------------------------------------------------------XXXXXX-------------
-------------------------------------------XX-------PBBBBBBB-----------------------------------------
--------------------------------------------------------------------------------E--------------------
-----------------------------------------------------------------------------XXXXX-------------------
----------------------------C-----------------------------------C-C------E---------------------------
----------B-------------------------------------------------------------XX---------------------------
BBB-BB-----------------------------------------------B------------------XX---------------------------
BBB-BB-------------------------X---------------------b------------------XX---------------------------
BBB-BB------E---E-----E-XX----XX---------------EE----B-------EE---------XX---------------------------
XXX-XXXXXXXXXXXXXXXXXXXXXXXXXXXX-XXXXXXXXX---XXXXXXXXXX-----XXXXXXXXXXXXXXXX------------XXXXXXXXXXX--
