-----------------------------------------------------------------------------------------------------
-----------------------------------------------------------------------------------------------------
---------------------------------------------------------------------------------------------BBBBBBBB
---------B-----------------------------C-----------------------------------------------------BBBBBBBB
---------------------X----------------XXX----------------------------------------------------BBBBBBBB
------------------------------X-----------------------------------PBBBPBBBBBBBBB-------------BBBBBBBB
-----XXXX-------------------------C--------------------E----------------------------------C--B-------
X----CCC----------------XXXX-----XXX------------------XX-------------------------------------B-------
X-C---------------------------------------------------XX--------------------------------------PCCCCCC
X-------------XX-XXX-----------------------------X----XX-------------BBBPBBBBBBB--------------PPBBBBB
X----------XX--------X--------------------------XX----XX-----------B---------------------------------
X-----------------------------------------------XXX---XX-----------b---------------------------------
X-----------------------------------E-----------XXX---XX--------X--B--------------X------------------
------------------------------XX-XXXXXXXXXXX----XXXXXXXXXXXXXXXXXXXXXXXXX-----XXXXXXXXXXXXXX-XXXXXXXX
