---------------------------------------------------------------------------------------------------------------------
---------------------------------------------------------------------------------------------------------------------
---------------------------------------------------------------------------------------------------------------------
---------------------------------------------------------------------------------------------------------------------
---------------------------------------------------------------------------------------------------------------------
----------------------C-C------------------------------------------C-C-----------------------------C-----------------
--------------------------------------------------CC------------------C----------------------------------------------
------C--C-----------C-C----C-----------------------C--C---C------C-----------C----C----------C----------------------
------------C-C-C--CC-BBP-----C-C--C-----C----CC------C-------C-C--PB------C-C-------------------C-------------------
---------B-C---C----------C------CC-CCC----CC-----PBB---C-------------B-----C---------CCC-C-----C--------------------
----------C--C------------B-B-B-P------C--C-----CC---------------C------------------PBBB-P-CCC-----------------------
----------BP-----------EE---------B--------B-BB---------------PPB-E-------------------------------SE-----------------
------S------------E--XXXX---------------------------E-----EE-----XXXX-EE-----S-------------------XXXX---------------
XXXXXXXXXX-------EXXXXXXXX---SE-------------------XXXXS---XXXX----XXXXXXXX---SXXXXS-S----E-----E-EXXXXXXXX-----------
XXXXXXXXXX----XXXXXXXXXXXXXXXXXXXX----------------XXXXXXXXXXXX----XXXXXXXXXXXXXXXXXXXXXXXX----XXXXXXXXXXXX-----------
