---------------------------------------------------------------------------------------------------------------------
---------------------------------------------------------------------------------------------------------------------
---------------------------------------------------------------------------------------------------------------------
---------------------------------------------------------------------------------------------------------------------
---------------------------------------------------------------------------------------------------------------------
-----------C-------------------------------C--------------C----------------------------------------------------------
------------C-C--C---------C--------------------C---C------C------CC------------CC-C-C-------------------------------
-------C--C------------C-CC----C------CCC---C--C--C--C------CC------CC------------C-C---------CC---------------------
------C--CBPBB-CC-CC--C----------CCCCC-------------C---C---------C-----C-------------------CC---CC-------------------
--------C-----PB--------C---BB--C--------------BBBBBB-C---------C-BBP-C--CC-----------CC-C---------------------------
------------------------------PBBB-----------------------------C--------C---C----------------C-----------------------
-----------ES---------------------BPBB----E----------------ES---------BBB-B---E-------BPPBP-PB-----------------------
----------XXXX---E-----------S------------XXXX-SE----E----XXXX----E-----------XXXX-EE----------ES--------------------
------S---XXXXXXXXE----ES-XXXXE----------EXXXXXXXXXXXXE---XXXX----XXXX--------XXXXXXXX--------XXXX-------------------
XXXXXXXXXXXXXXXXXXXXXXXXXXXXXXXXXX----XXXXXXXXXXXXXXXXXXXXXXXX----XXXX--------XXXXXXXX--------XXXX----XXXX-----------
