--------------------------------------------------------------------------------------------------------------------
--------------------------------------------------------------------------------------------------------------------
--------------------------------------------------------------------------------------------------------------------
--------------------------------------------------------------------------------------------------------------------
--------------------------------------------------------------------------------------------------------------------
----------------B-BBBBB--------------------------------------------------B------B---------------BBBBB---------------
--------------------------------------------------------------------------------------------------------------------
----------------------------------------------------------------------------------------------C---------------------
--------------------------------------------------------------------------------------------------------------------
----------------BB--B-------------X---------------------------------------------------------BBB---------------------
----------------------------------X---XX----------------------------------------------------------------------------
------------------------------SXX-----XXX----------------------------------------------SXX--------------------------
-----------------------C------EEXX---XXXX----------------------------------------------EEX--------------------------
XXXXXXXXXXXXXXXXXXXXXXXXXXXXXXXXXXXXXXXXXXXXXXXXXXXXXXXXXXXXXXXXXXXXXXXXXXXXXXXX--XXXXXXXXXXXXXXXXXXXXXXXXXXXXXXXXXX
