---------------------------------------------------------------------------------------------------------------------
---------------------------------------------------------------------------------------------------------------------
---------------------------------------------------------------------------------------------------------------------
---------------------------------------------------------------------------------------------------------------------
---------------------------------------------------------------------------------------------------------------------
----------------------C-CC--C---C-----------------------------------------C--C---------------------------------------
-------C------C-C--C------CC---C---------C-----CC--------CC-C------CCC-C-C-C--C-CC-------C---------------------------
----------CCC--C-CC----C---------C----C---C------C-C-C-C----------------C---C---------CCC-----C--CC------------------
------C------C------------BBBB-BBB--C---------PB-P----------------PBBB---------C---C-C-PBB-----CC--------------------
------BBBB------------------------C--C-----CCC-----------------CC-----P-B-------------------CC-----------------------
-----------BBB---------------------C--------------B--------------C------------------------CC-------------------------
------------------S----EE----EE---BPB----E-----EE----------------BE----------E-----------EBPP------------------------
------E----------SXXXXXXXXXXXXXXXX----XXXX----XXXX----E----EE-----XXXX-ES-XXXXE-------XXXX---------------------------
XXXXXXXXXX-EE-XXXXXXXXXXXXXXXXXXXX----XXXXS---XXXX---SXXXXXXXX----XXXXXXXXXXXXXXXX----XXXX-----ESS-S-----------------
XXXXXXXXXXXXXXXXXXXXXXXXXXXXXXXXXX----XXXXXXXXXXXXXXXXXXXXXXXX----XXXXXXXXXXXXXXXX----XXXX----XXXXXXXX---------------
