-----------------------------------------------------------------------------------------------------
-----------------------------------------------------------------------------------------------------
-----------------------------------------------B---------------P-----------------BBBBBBBBBBBBBBBBBBBB
-----------------------------------------------B---------------------------------BBBBBBBBBBBBBBBBBBBB
-----------------------------------------------B---------------------------------BBBBBBBBBBBBBBBBBBBB
-----------------------------------------------B---BB-----------------BBB--------BBBBBBBBBBBBBBBBBBBB
-----------------------------------------------B---------------------------------B-------------------
---------------X-------------------------------B----------------------B----------B-------------------
-----------CC----------CCC---------------------B---------B----B----BBB-B----------PCCCC---P--E-EE----
X----BB----------------------------------------B---BP---E---------------B---------PPBBB-BBPPBBBBBBBBB
X----E-----------------------------------------B--------E-------------------------------B---BBBBBBBBB
X----------------------------------------------B-B--------------------------------------B---BBBBBBBBB
----------------------------E------------------B-b-------------------------XXXX----------CCCBBBBBBBBB
---XXXXXXXXXXXXXXXXXXXXXXXXXXXXXXXXXXXXXXXXXXXXXXXXXXXXXXXX--XXX---XXXXXXX-------XXXXXXXXXXXXXXXXXXXX
