---------------------------------------------------------------------------------------------------------------------
---------------------------------------------------------------------------------------------------------------------
---------------------------------------------------------------------------------------------------------------------
---------------------------------------------------------------------------------------------------------------------
---------------------------------------------------------------------------------------------------------------------
----------------------------------------C-----------------------------------------CC-------C-------------------------
-------C-----C---------------CC-----C-CC----------------------------------CCC---C------C-C--CC-----------------------
------------C-C--C-C-C----C-------CC-----------C-C-C-----C--C-C----C----------------C-C--------C-CC------------------
------C--CBB-B------C-C--C--PBPBB----C------C---------C-C-C----CCC--CC-CC-----------------B-BB--C--------------------
---------B-----CC-----------------------------C-C------------C--BPBBPB-------------------P----C----------------------
---------------B-----------------------------CB--B--B-BB-B------------------------------------B----------------------
-----------ES----------------ES----------E-----------------------------B-----S-----SE-----S--------------------------
------E---XXXX----S-------XXXXXXXX-EE-XXXX-----------------------ES-------XXXXE---XXXX---EXXXX-----------------------
XXXXXXXXXXXXXX---EXXXX-SE-XXXXXXXXXXXXXXXX-----EE----EE----ES-XXXXXXXX----XXXXXXXXXXXXXXXXXXXX-SESES-----------------
XXXXXXXXXXXXXXXXXXXXXXXXXXXXXXXXXXXXXXXXXX----XXXXXXXXXXXXXXXXXXXXXXXX----XXXXXXXXXXXXXXXXXXXXXXXXXXXX---------------
