-----------------------------------------------------------------------------------------------------
-----------------------------------------------------------------------------------------------------
BBBBBBBB------------------------------------------------------BBBBBBBB-------------------------------
-----------------------------------------------------------------------------------------------------
-----------------------------------------------------------------------------------------------------
-------------------BB----------BBB-----------------B---------------------E--XXX----------------------
----------------------------------------------------------------------------XXX------------C---------
---------------------------------------------------------------------------XXXX-----------XXX--------
----------X-------------------------------------------E-----------B------EXXXXX----------------------
-X-XX----XX-----B-BBBB-----------------------------B-XX--------------B--XXXXXXX----------------------
EXXXX--XXXX------------------------------------------XX-----------------XXXXXXX----------------------
XXXXX-XXXXX-------------X----------------------------XX-----------------XXXXXXX----------------------
XXXXX-XXXXX------------XX-------E---E----------------XX----E------------XXXXXXX------E--------E------
XXXXXXXXXXXXXXXXXXXXXXXXXXXXXXXXXXXXXXXXXXXXXX--XXXXXXXXXXXXXXXXXXXXXX-XXXXXXXXXXXXXXXXXXXXXXXXXXXXXX
