-----------------------------------------------------------------------------------------------------
-----------------------------------------------------------------------------------------------------
-----------------------------------------------------------------------------------------------------
-------------------------------------------------------------------C---------------------------------
-----------------------------------------------------------------------------------------------------
------XX------------------------------------------------------BBBPBB---------------------------------
BB----XX---------------------------------------------------------------------------------------------
-----XXX--------------------------------------------------------------------------X------------------
----XXXX-------------------------------------------------------------------E----------------E--------
---XXXXX---------------------XX-----------E---------------B--BBBBBB---BB--XX---------------XX--------
--XXXXXX----------E---XX-----------------XX-------------------------------XX---------------XX--------
-XXXXXXX---------XX---XX-----------------XX-------------------------------XX------------X--XX--------
XXXXXXXX---------XX---XX---------E--E----XX-------EE---------------E------XX-----E-E----X--XX--------
XXXXXXXXXXXXXXXXXXXXXXXXXXXXX-XXXXXXXXXXXXXXXXXXXXXXXXXXXXXXXXXXXXXXXXXXXXXXXXXXXXXXXXX-XXXXXXXXXXXXX
