-----------------------------------------------------------------------------------------------------
-----------------------------------------------------------------------------------------------------
BBBBBBBBBBBBBBBB-------------------------------------------------------------------------------------
-----------------------------------------------------------------------------------------------------
P----------------------------------------------------------------------------------------------------
PP---------------------------------------------------------------E--CCCC-----------------------------
------------------------------E--------------------------------XXXXXX--------------------------------
-----------------------------XX----------------------------------------------------------------------
-----------------------------XX--------------------------------------------------------E-------------
BBBBB-------BBBB-XXX---E-----XXX---------------BB-----------------------XXXXXX--B-----XX------------B
----------------------XX--------------------------------------------------------------XX-------------
----------------------XX--------------------------------------------------------------XX-------------
-----------E----------XX----------------EE--------------X-----------------------------XX-------------
XXXXXXXXXXXXXXXX-----XXXXXXXXXXXXXXXXXXXXXXXXXXXXXXXXXXXXXXXXXX-----------------XXXXXXXXXXXXXXXXXXX-X
