-----------------------------------------------------------------------------------------------------
-----------------------------------------------------------------------------------------------------
----------------------BBBBBBBBBBBBBBBBBBBBBBBBBBBBBBBBBBBBBBBBBBBBBBBBBBBBBBBBBBBBBBBBBB-------------
-------------------------------BBBBB---BBBBBB--------------BBB--------BBBBB--------------------------
---------------C------------E--BBBBB---BBBBBB--------------BBB--------BBBBB--------------------------
BBBBBBBBBBBB---X------------BBB-----------B-----------------BB---------------------------------------
-----------------CCC--------BBB-----------B-----------------BB---------------------------------------
----------------------------BBB-----------B-----------------BB---------------------------------------
----------------------------BBB--------CCCBCPP-----E--E----CBB--------CCCCPP---------------E---------
--------B-----------------E-BBBBBBBB---BBBBBB-----XX-XX----BBB--------BBBBB---------------XX---------
E-------------P----------XX----BBBBB--------------XX-XX--------------------------------B--------E----
X------------------------XX----BBBBB--------------XX-XX--------------------------------B------B------
X-----E------------------XX---E---------E---------XX-XX--E---E-------------------E-----B-E----b------
XXXXXXXXXXXXX-XX-XXXXXXXXXXXXXXXXXXXXXXXXXXXXXXXXXXX-XXXXXXXXXXX-----XXXXXXXXXXXXXXXXX-XXXXXXXXXXXXXX
