---------------------------------------------------------------------------------------------------------------------
---------------------------------------------------------------------------------------------------------------------
---------------------------------------------------------------------------------------------------------------------
---------------------------------------------------------------------------------------------------------------------
---------------------------------------------------------------------------------------------------------------------
--------------------------------C-------------C----------------------------------------------------------------------
------------CC----------------C-------CCC-----------C--------------C---CC-----C--------------------------------------
--------C-CC---------------CC--C----------CC-----C---C-C----------C-CCC--C-------C-C-C-------------C-----------------
------C---BBPB---------CCC------P-C-CC--------BB---P---------C--C-----------C-----C-C-------CC-----------------------
-------C------------C-----------------------C---------C-C-C-C--C--BBBPB-P--C--------------C--------------------------
-------PBB----C--CCC---------B-----C--------B--------------------C--------C--C---------P-B-C--C----------------------
-----------SE-B---------------S---B------E-----ES----S-----------B------------------------BBBB----EE-----------------
----------XXXX----------------XXXX----XXXX----XXXXXXXX------------S----EE-----E-------------------XXXX---------------
------E---XXXX---------------EXXXX----XXXXE---XXXXXXXXS----ES-----XXXXXXXX----XXXX-SS----E--------XXXX---------------
XXXXXXXXXXXXXX------------XXXXXXXX----XXXXXXXXXXXXXXXXXXXXXXXX----XXXXXXXX----XXXXXXXXXXXX--------XXXX---------------
