--------------------------------------------------------------------------------------------------------------------
--------------------------------------------------------------------------------------------------------------------
--------------------------------------------------------------------------------------------------------------------
--------------------------------------------------------------------------------------------------------------------
--------------------------------------------------------------------------------------------------------------------
----------------------------------------------------------------------------BBBP------------------------------------
--------------------------------------------------------------------------------------------------------------------
--------------------------------------------------------------------------------------------------------------------
--------------------------------------------------------------------------------------------------------------------
--------------------PB-P------SXX----B------------------------------------BB-BB--P------SX-------X------------------
------------------------------EEX-----XX------------------------------------------------EX---X--XXX-----------------
---------------SXX------------EEX-----XXX-----------------------------------------------E---XXXXXXX-----------------
---------------EEXC-C------C--EEXC----XXX---------------------------------C-------------E---XXXXXXXX----------------
XXXXXXXXXXXXXXXXXXXXXXXXXXXXXXXXXXXXXXXXXXXXXXXXXXXXXXXXXXXXXXXXXXXXXXXXXXXXXXXXXXXXXXXXXXXXXXXXXXXXXXXXXXXXXXXXXXXX
