-----------------------------------------------------------------------------------------------------
-----------------------------------------------------------------------------------------------------
-----------------------------------------------------------------------------------------BBBBBBBBBBBB
-----------------------------------------------------------------------------------------------------
----------------------------------------------------------------------CC-----------------------------
BBBBB------------------------B--------------------------------------C----XXC---------BB--------------
-----------------------------------------------------------------------------------------------------
----------------------------E------------------------------------------------------------------------
BBBBB--E---------B--------------------------------------------------------------CC-------------------
------XX------------B--BBBBPB-----------------------B----------------X------XX-----XX------------E---
------XX------------------------E-------E--X-----E---------------------------------XX-----------XX--E
------XX-----------------------XX------XX--X----XX---------------------XX----------XXX----------XX-XX
------XX-----------EE----------XX------XX--X----XX------E-E------------------------XXX----------XX-XX
-----XXXXXXXXXXX-XXXXXXXXXXXXXXXXXXXXXXXXXXXXXXXXXXXXXXXXXXXXXXXX------------------XXXXX------XXXXXXX
