-----------------------------------------------------------------------------------------------------
-----------------------------------------------------------------------------------------------------
-----------------------------------------------------------------------------------------------------
-----------------------------------------------------------------------------------------------------
-----------------------------------------------------------------------------------------------------
BBB--------------------------------------------------------------------------------------------------
----------------------------------E------------------C-----------------------------------------------
---------------------------------XX-----------------XXX------------------------CC--------------------
---------------------------------XX------------------------------------------------------------------
BBB------------------------------XX---B-B--XXX--------------------------E----------B--------------XX-
---------------------------------------------------------E--------XXXXXXXXXXX---------------------XX-
-----------------X------C-------------------------------XX----------------------------------------XX-
-------E---------X----XXXX----E---------------XXXXX-----XX-X-------------------------------E------XX-
--XXXXXXXXXXXXXXXXX---------XXXXXXXXXXXXXX----------XXXXXXXXXXXXX---------------XXXXXXXXXXXXXXXXXXXXX
