---------------------------------------------------------------------------------------------------------------------
---------------------------------------------------------------------------------------------------------------------
---------------------------------------------------------------------------------------------------------------------
---------------------------------------------------------------------------------------------------------------------
---------------------------------------------------------------------------------------------------------------------
----------------------------------------C-------------C---------------------------C----------------------------------
------------------C-------CC-----CCCCC-----------------------C--CCC-C---C-C-C-------CC--C---CC-----------------------
-------------------CCCC---------------CC-C--------C----C---C---------C---C-----C-C-----C---C--C--C-------------------
-----------C--CC--------CC--C-------------CC--C------C--------CC---BBB-----C-CC----------BB-------CC-----------------
------CC--C---B------------B-B-PPPBB-----------C---C-----------PB-----BBBB-B-------------------CC--------------------
--------CC--C-------------------------------------P-P----------------------------------------------------------------
-------BBBPBBP----S----------------------S----BPBB----E-----------S----------------SS----ES--------------------------
-----------------EXXXX-EE----EE----EE-XXXXE-----------XXXX-EE----EXXXX-EE----SE---XXXXXXXXXXXX----SE--XXXX-----------
XXXXXX--------XXXXXXXXXXXXXXXXXXXXXXXXXXXXXXXX-------EXXXXXXXXXXXXXXXXXXXXXXXXXXXXXXXXXXXXXXXX-EE-XXXXXXXX-----------
XXXXXX--------XXXXXXXXXXXXXXXXXXXXXXXXXXXXXXXX----XXXXXXXXXXXXXXXXXXXXXXXXXXXXXXXXXXXXXXXXXXXXXXXXXXXXXXXX-----------
