---------------------------------------------------------------------------------------------------------------------
---------------------------------------------------------------------------------------------------------------------
---------------------------------------------------------------------------------------------------------------------
---------------------------------------------------------------------------------------------------------------------
---------------------------------------------------------------------------------------------------------------------
-----------------------------------------------C------------------------------------C---------CC-C-------------------
-----------------------C----C-C--C------------C------------------CC--------CC----C-----------------------------------
---------C--------C--C--C--C-C--C----CC---C------C--C------C----C------CC----C-------CCC----C------C-----------------
------C-----C-C-C--------CBBBB---------CC---C--BBB-----CC------C---CCCC--CC---CC----PP--C----C-----------------------
--------P----C-----------B----B-----C--------------C------C-------BPBB----B---------------B--------------------------
--------------------------------------------------BPB-C---------------BP-B--------------PB---------------------------
-----------B------E----------S-----------------SE----------------------------------EE----------SEE-------------------
------E-----------XXXX-SE-XXXXS---------------XXXX---------------EE----------SE---XXXX----E---XXXXEE-----------------
XXXXXXXXXX-------EXXXXXXXXXXXXXXXX-EE----SE---XXXX---S-----ES-XXXXXXXX-EE-XXXXXXXXXXXX---EXXXXXXXXXXXXXXXX-----------
XXXXXXXXXX----XXXXXXXXXXXXXXXXXXXXXXXXXXXXXXXXXXXXXXXX----XXXXXXXXXXXXXXXXXXXXXXXXXXXXXXXXXXXXXXXXXXXXXXXX-----------
