-----------------------------------------------------------------------------------------------------
-----------------------------------------------------------------------------------------------------
-----------------------------------------------------------------------------------------------------
-----------------------------------------------------------------------------------------------------
----------------------------------------------------------------------------------------CC-----------
---XXX----XXXX----------------XX---------------------------------------------------------------------
--XXXX------------------------XX-----------------------------------------------XXXXXX----------------
-XXXXX-----------------------XXX---------------------------------E-----------------------------------
XXXXXX--------X-------------XXXX-----------------E--------------XX---XBB-----------------------------
XXXXXX---X--X----------B---XXXXX--E-X-----------XX--------------XX---XX------------------XXXXXX-XXX--
XXXXXX---------------------XXXXX-XX----------E--XX--------E-----XX--XXX------------------------------
XXXXXX---------------------XXXXX-XX---------XX--XX-------XX-----XX-XXXX--XXXXXXX---------------------
XXXXXX-----------------E---XXXXX-XX---E-E---XX--XX-------XX-E-E-XX---XX------------------------------
XXXXXXXX-------XXXXXXXXXXXXXXXXXXXXXXXXXXXXXXXXXXXXXXXXXXXXXXXXXXXXXXX-------------------------------
