---------------------------------------------------------------------------------------------------------------------
---------------------------------------------------------------------------------------------------------------------
---------------------------------------------------------------------------------------------------------------------
---------------------------------------------------------------------------------------------------------------------
---------------------------------------------------------------------------------------------------------------------
--------------CC-----------------C-----------------------------C---CC------------------------------------------------
----------------C----------C-------------------C----------------CC------CC-CC-----------------C---CC-----------------
----------CCCC---C------C----C--C----C-C-C-------------C--CC-CC------C-------CC------------------C-------------------
-------C------B----C-C---C----BBP-------C--C-C--BB-C--C-C---C---B-PBBPPBBBC------CC-------C-C---C--------------------
-----------------------C-----P----CCC-C---C-C--------CB-------------------B--------CCCC-C-----P----------------------
------C-C-BBBP--------------------B---------------C------------------------------------C-----------------------------
---------B-------S------------S----------------EE-PBBB-----------SE----EE-------------BBBBBPBP-----------------------
--------------XXXX-----------EXXXX------------XXXX----S-------XXXXXXXXXXXX---EE----------------E-SES-----------------
-----------SS-XXXX-----EE-XXXXXXXX-EE----S----XXXX----XXXX-EE-XXXXXXXXXXXXXXXXXXXX-SS---------XXXXXXXX---------------
XXXXXX----XXXXXXXX----XXXXXXXXXXXXXXXXXXXX----XXXX----XXXXXXXXXXXXXXXXXXXXXXXXXXXXXXXX--------XXXXXXXXXXXX-----------
