---------------------------------------------------------------------------------------------------------------------
---------------------------------------------------------------------------------------------------------------------
---------------------------------------------------------------------------------------------------------------------
---------------------------------------------------------------------------------------------------------------------
---------------------------------------------------------------------------------------------------------------------
-----------C-CC-C--------------------C---------------------------------------C---------------------------------------
------------C-----------------------C--C--C-C------C---------------------------------C-----C--C-C--------------------
---------CC-----------------------CC-----C----------C-----C-----C-----C--CC-C-C--C--C--CC-C----C-C-------------------
----------BBBBB-----C-C----C-----C------C--C-CCC--------------------C---C-------------C---BBBP-----------------------
------C-C--------------------C--------------BB----B--P-C-----C-C-C--------------C------------------------------------
---------------------------B-B--C-------------B-B-----B-------P-P-----BPB---------------BB--------C------------------
-----------EE----S-------------BB--SE-----------------------------BBB--------S------------E----S-S-------------------
----------XXXXXXXX----------------XXXX---EE----------S--------------------XXXX----E-E-----XXXXXXXX----XXXX-----------
------E---XXXXXXXX-----------E----XXXXXXXXXXXX-EE-XXXXE----EE----E-----SE-XXXXE---XXXX---SXXXXXXXX----XXXX-----------
XXXXXXXXXXXXXXXXXX--------XXXX----XXXXXXXXXXXXXXXXXXXXXXXXXXXXXXXX----XXXXXXXXXXXXXXXXXXXXXXXXXXXX----XXXX-----------
