-----------------------------------------------------------------------------------------------------
-----------------------------------------------------------------------------------------------------
------------------E-------------------------------------------------------------------------------E--
-----------------------------------------------------------------------------------------------------
-------------------------------------------CC--------------------------------------------------------
-----B--BBBBB----------B----------E------------------------------------------------------------------
---------------------------------XX-----------XXXX---------------------------------------------------
---------------------------------XX------------------------------------------------------------------
-E-------------------------------XXX-----------------------------------------------------------------
XX---BBBBBBBB---------X------------------------------------------------------------------------------
---------------E-----XX------------------------------------------------------------------------------
--------------------XXX---------------------XXX-----------------------------------------------------X
------------------XXXXX---------------------------------------------E--------E-------EE--------E--XXX
XXXXXXXXXXXXXXXXXXXXXXXXXXXXXX-XXXXXXXX---------XXXXXXXXXXXXXXXXXXXXXXXXXXXXXXXX---XXXXXX---XXXXXXXXX
