---------------------------------------------------------------------------------------------------------------------
---------------------------------------------------------------------------------------------------------------------
---------------------------------------------------------------------------------------------------------------------
---------------------------------------------------------------------------------------------------------------------
---------------------------------------------------------------------------------------------------------------------
----------------C--------------------C-----------------------------------------------------------C-------------------
--------------CC-C-----CC-------------------------------------C---C--C--C-----------------C-C-CCC--------------------
--------------------------C-CC-----CC-----------C---------C----C-C-C--------------------C---------C------------------
------------CCPBB-CCCCC--C-------------C---C------C---C-C-------C----------CC--C---C------BB-------C-----------------
--------C------------------------C----C-------CC-C----------C--BBPBBBBB---C--C--CC---C-------------------------------
------C--C-----------------PBP------------C-----BBBP-B-C----------------------C-----PBBPBB---------------------------
-------BBBBBBB---E------------BBB--EE-----------------B-----------------------------------S----EEE-------------------
XXXXXX--------XXXX-----ES---------XXXX---------------------------SE----ES-----------------XXXXXXXX-E-----------------
XXXXXX--------XXXX----XXXX---E----XXXX---------EE----E-----ES-XXXXXXXXXXXX---------SS----EXXXXXXXXXXXX---------------
XXXXXX--------XXXX----XXXXXXXX----XXXX--------XXXXXXXX----XXXXXXXXXXXXXXXX--------XXXXXXXXXXXXXXXXXXXX---------------
