--------------------------------------------------------------------------------------------------------------------
--------------------------------------------------------------------------------------------------------------------
--------------------------------------------------------------------------------------------------------------------
--------------------------------------------------------------------------------------------------------------------
--------------------------------------------------------------------------------------------------------------------
------------------BBPP------------------------------------------------------------------------BBBBB-B---------------
--------------------------------------------------------------------------------------------------------------------
--------------------------------------------------------------------------------------------------------------------
--------------------------------------------------------------------------------------------------------------------
--------------------P---------------------------------------------------------P--P-----SXX---B----------------------
------------------------------SXX------X-----------------------------------------------EEX--------------------------
-----------------------------EEEX-----XXX--------------------------------SXX-----------EEX--------------------------
--------------------C----C-C-EEEXC----XXXX-------------------------------EEXC-C------C-EEX------CCC-----------------
XXXXXXXXXXXXXXXXXXXXXXXXXXXXXXXXXXXXXXXXXXXXXXXXXXXXXXXXXXXXXXXXXXXXXXXXXXXXXXXXXXXXXXXXXXXXXXXXXXXXXXXXXXXXXXXXXXXX
