---------------------------------------------------------------------------------------------------------------------
---------------------------------------------------------------------------------------------------------------------
---------------------------------------------------------------------------------------------------------------------
---------------------------------------------------------------------------------------------------------------------
---------------------------------------------------------------------------------------------------------------------
-------------------------------C---C---------------------------------------------C----------------CC-----------------
----------------C-------------C---C--C----CCC---------C-------------C---CC-C-----------------------------------------
-----------------C-C--C--C------CC----C-C--------C------------CC---C-C-C----CCC----C------C--------------------------
--------------CC-----C----BBBBBB-------C-CP--P----CC---C---C-----CC-------C-----------------CC-C-C-------------------
--------C---------C----CC---------------------C-C---C-----------C-PBB-BBB------------CCCCCP-B---C--------------------
------C--C-CC------------P--------------------BPPB---C----C------B-------------------B-PB-----C----------------------
--------BPPBP----------------SS----ES-----E-------P-B-------------------------S-------------------EE-----------------
-----------------E--------XXXXXXXXXXXX---EXXXX--------E-----------S----EE----EXXXX--------E-------XXXX---------------
XXXXXX--------XXXXE----EE-XXXXXXXXXXXXXXXXXXXX-SS-----XXXX-------EXXXXXXXXXXXXXXXX-EE----EXXXX----XXXX---------------
XXXXXX--------XXXXXXXXXXXXXXXXXXXXXXXXXXXXXXXXXXXX----XXXX----XXXXXXXXXXXXXXXXXXXXXXXXXXXXXXXX----XXXXXXXX-----------
