-----------------------------------------------------------------------------------------------------
-----------------------------------------------------------------------------------------------------
---------------------------------------------------------------BBBBBBBBBBBB--------------------------
------------------------------------------------------C----------------------------------------------
-------------------------------------------------------------------------------------------------E---
-----------------X--------------------BBBB--E---BBBBBBB--------------------------------------BBBBBBB-
-----------------X-------------------------XX--------------------------------------------------------
----------------XX-------------------E-----XX---------------------------------X----------------------
BBBBBBBBBP-----XXX-------------------------XX-----E-E-------------------------X-CC-BBBBBB------------
--------------XXXX--------B-------BBPB---EBXXX--BBBBBB----XX------------------X------------E---------
--------------XXXX----------------------XX----------------XX--------------XXX-X-----------XX---------
--------------XXXX--------------X-------XX----------------XX------------XXXXX-X-----------XX---------
--E-----------XXXX-------------XX-------XX------------E---XX----E------XXXXX--X-----E-----XX--------E
XXXXXXXXXXXXXXXXXXXXXXXXXXXXXXXXXXXXXXXXXXXXXXXXXXXXXXXXXXXXXXXXXXXXXXXXXXX---X--XXXXXXXXXXXXXXXXXXXX
