--------------------------------------------------------------------------------------------------------------------
--------------------------------------------------------------------------------------------------------------------
--------------------------------------------------------------------------------------------------------------------
--------------------------------------------------------------------------------------------------------------------
--------------------------------------------------------------------------------------------------------------------
---------------BBP---BB----------------B----------------------------------------------------------------------------
--------------------------------------------------------------------------------------------------------------------
--------------------------------------------------------------------------------------------------------------------
--------------------------------------------------------------------------------------------------------------------
---------------------------------------------------------------------------------------BB----B-B--------------------
---------------------------------X----------------------------------------------------------------------------------
-----------------------------SXXXX----------------------------------------------------------------------------------
-----------------------------EXXXXX-------------------------------------------------C-------------------------------
XXXXXXXXXXXXXXXX-XXXX---XX---EXXXXXXXXXXXXXXXXXXXXXXXXXXXXXXXXXXXXXXXXXXXXXXXXXXXXXXXXXXXXXXXXXXXXXXXXXXXXXXXXXXXXXX
