-----------------------------------------------------------------------------------------------------
-----------------------------------------------------------------------------------------------------
-------------------------------------------------------------BBBBBBBBBBBBBBBBBBBBBBBBBBBBBBBBBBBBBBBB
-----------------------------------------------------------------------------------------------------
-----------------------------------------E----E------------------------------------------------------
-------BBB-----------------BB-----------BBBBBBBBBBB--------BB---------CCCCCCC-C----------------------
--------------------CC-------------------------------------------------------------------------------
----------------------------------------------------C-----------B-B-B-BBBBBBB-B-B-B----------B-B-B-B-
E-----------------E------------------------------E--------------BCBCBCB---B-BCBCBCB----------BCBCBCBC
BB--X-XXXXXX-----XX--------BB-----------BBBBBBBBBBBB---BPBBBB---BBBBBBB---B-BBBBBBB-------E--BBBBBBBB
---XXXXX---------XX----------------------------------------------------------------------XX----------
-E-XXX-----------XX-----------B----------------------------------------------------------XX----------
---XX------------XX-----------b----E-----------------------------------EEE-E----------E--XX----------
XXXXX---X-------XXXXXXXXXXXXXXXXXXXXXXXXXXXXXXXXXXXXXX-XXXXXXXXXXXXXXXXXXXXXXXXXXXXXXXXXXXXXXXXXXXXXX
