---------------------------------------------------------------------------------------------------------------------
---------------------------------------------------------------------------------------------------------------------
---------------------------------------------------------------------------------------------------------------------
---------------------------------------------------------------------------------------------------------------------
---------------------------------------------------------------------------------------------------------------------
----------C-CC-----------------C----C----------C---------------------------------------------------------------------
-----------C------C------C-------C---C----C-C-----------------------------C--CC-------------------CC-----------------
-------------------C---CC-----C----C-----C-C-C--C-C---------------------C--------------------------------------------
-------C---BBB-C--------BB-C-----------C-----B-BP-----C------------CC----C-C---C-------CC-C---C--C-------------------
----------------C------------C---------------------------CC-CCC--CC----C--B-B------CC-C------------------------------
------C-CC----C--C--------PPP----------------------B-B--C------C------BBBP-------------------C-----------------------
-------BPB-EE-B---E----EE------E---EE-----E----ES-----P------------PBB--------------------PBB-----EE-----------------
XXXXXX----XXXX----XXXXXXXX----XXXXXXXX---SXXXXXXXX---------------------------SS-------------------XXXX---------------
XXXXXX----XXXX----XXXXXXXX---SXXXXXXXXXXXXXXXXXXXX---E-----------------EE-XXXXXXXX-------------E--XXXXXXXX-----------
XXXXXX----XXXX----XXXXXXXXXXXXXXXXXXXXXXXXXXXXXXXXXXXX----------------XXXXXXXXXXXX------------XXXXXXXXXXXX-----------
