-----------------------------------------------------------------------------------------------------
-----------------------------------------------------------------------------------------------------
CCCCCC-----------------------------------------------------------------------------------------------
-----------------------------------------------------------------------------------------------------
---------------------------------------------------------------------------------E-------------------
XXXXXXXXX------------XXXXX------------------------------------------------------BBBBBBBBBBBBB--------
--------------------XXXXXX---------------------------------------------------------------------------
-------------------XXXXXXX---------------------------------------------------------------------------
--------------E---XXXXXXXX---------------------------------------------------------------------------
-----------E-XX--XXXXXXXXX-----BB-----------------------------------------------BBBPBBBBBBBBB---XXXXX
----------XX-XX--XXXXXXXXX--------------E------------------------------------------------------------
----------XX-XX--XXXXXXXXX-----E-------XX------------------------------------------------------------
----------XX-XX--XXXXXXXXX-------------XX-------------E--E-------------------------------------C-----
----------XXXXX--XXXXXXXXXXXXXXXXXXXXXXXXXXXXXXXXXXXXXXXXXXXXXXXXXXXXXXXXXXXXXXXXXXX-----XXXXX-X-----
