--------------------------------------------------------------------------------------------------------------------
--------------------------------------------------------------------------------------------------------------------
--------------------------------------------------------------------------------------------------------------------
--------------------------------------------------------------------------------------------------------------------
--------------------------------------C-----------------------------------------------------------------------------
-------------------------------------BBBBBB-------------------------------------------------------------------------
--------------------------------------------------------------------------------------------------------------------
------------------------------------C-------------------------------------------------------------------------------
--------------------------------------------------------------------------------------------------------------------
-------------------BBBPB-----P----BBB----------------------------------------------------SXX------------------------
-----------------------------------------------------------------------------------------EEX------------------------
-----------------------------E-----------------------------------------------------------EEX------------------------
-----------------------------E----------------------------------------------------CC-C---EEX------CC----------------
XXXXXXXXXXXXXXXXXXXXXXXXXXXXXXXXXXXXXXXXXXXXXXXXXXXXXXXXXXXXXXXXXXXXXXXXXXXXXXXXXXXXXXXXXXXXXXXXXXXXXXXXXXXXXXXXXXXX
