--------------------------------------------------------------------------------------------------------------------
--------------------------------------------------------------------------------------------------------------------
--------------------------------------------------------------------------------------------------------------------
--------------------------------------------------------------------------------------------------------------------
--------------------------------------------------------------------------------------------------------------------
------------------BBBP----------------------------------------------------------------------------------------------
--------------------------------------------------------------------------------------------------------------------
--------------------------------------------------------------------------------------------------------------------
--------------------------------------------------------------------------------------------------------------------
-----------------P------------------X--X-XX--------------------------------------------------XXX---XX---------------
-------------------------------SXX--X---XXX------------------------------------------------X-XX----XX---------------
-------------------------------EEX-XX---XXX-----------------------------------------------XXXXX---XXX---------------
--------------------------C----EEX-XX---XXX----------------------------------------------XXXXX----XXX---------------
XXXXXXXXXXXXXXXXXXXXXXXXXXXXXXXXXXXXXXXXXXXXXXXXXXXXXXXXXXXXXXXXXXXXXXXXX---X-------------XXXX----XXXXXXXXXXXXXXXXXX
