---------------------------------------------------------------------------------------------------------------------
---------------------------------------------------------------------------------------------------------------------
---------------------------------------------------------------------------------------------------------------------
---------------------------------------------------------------------------------------------------------------------
---------------------------------------------------------------------------------------------------------------------
------------C------------------------C------------------------CC-----------------------------------------------------
-------------C------------C-----C--CC---------------------CCC---C----C------------CC----------C-C--------------------
-------C-C---------C-C--------C--CC----C------CC-C-----------C---C------------------C------------C-------------------
--------C-B-PB-C----C---CC---C--------------CC------C------------------C--CCC--CC----C-----C---C---C-----------------
------C-------C-C-C---CC--PBBP-BB----------C--BPB-C------C---------B-BC---B-----------------------C------------------
--------BB----B-------PPPB------------------BB-----C---CC---------------CC-------C--------C--------------------------
-----------SS----------------------SE-------------B--------SS----E----BBP-------------BBP-B--------------------------
----------XXXX---------------ES---XXXX---E-----SE---------XXXXXXXXE----------S-----SE----------SE--------------------
------E---XXXX---EE----EE-XXXXXXXXXXXXXXXXE---XXXX--------XXXXXXXXXXXX----XXXX----XXXX--------XXXX----XXXX-----------
XXXXXXXXXXXXXXXXXXXXXXXXXXXXXXXXXXXXXXXXXXXXXXXXXX--------XXXXXXXXXXXX----XXXX----XXXX--------XXXX----XXXX-----------
