-----------------------------------------------------------------------------------------------------
-----------------------------------------------------------------------------------------------------
-----------------------------------------------------------BBBBBBBBBBBBBBBBBBBBBBBBB-----------------
-----------------------------------------------------------BBBBBBBBBBBBBBBBBBBBBB--------------------
-----------------------------------------------------------BBBBBBBBBBBBBBBBBBBBBB--------------------
-----------------------------------------------------------BBBBBBBBBBBBBBBBBBBBBB--------------------
-----------------------------------------------------------B-----------------------------------------
B--C-------------X---------------------------------------X-B----------------------------XX-----------
--------------------------------------------------------XX--PCCCCCCCCCCCCCCCC-----------XX-CCC-B-----
-BB---------------------------------------------------XXXX--PPBBBBBBBBBBBBBBB----XX--X--XX--------B--
------------------------------------------------------XXXX----------------------XXXXXX-XXX-----------
--BBB-------------------------------------------------XXXX---------------------XXXXXXXXXXX-----------
-------E--------E---------E--E-X------EE-----X--------XXXX--------E--E-EEEE---XXXXXXXXXXXX----------E
-----XXXXXXXXXXXXXXXXXXXXXXXXXXXXXXXXXXXXXXXXXXXXXXXXXXXXX-XXXXXXXXXXXXXXXXXXXXXXXXXXXXXX------XXXXXX
