-----------------------------------------------------------------------------------------------------
-----------------------------------------------------------------------------------------------------
BBBBBBBBBBBBBBBBBBBBBBBBBBBBBBBBBBBBBBBBBBBBBBBBBBBBBBBBBBBBBBBBBBBBBB-------------------------------
-BBBBBBBB-BBBBB--------------------------------------------------------------------------------------
-BBBBBBBB-BBBBB--------------------------------------------------------------------------------------
----------BBBBB------------------------------------------E----------------------------------BBB--X---
--------------------------------------------------------XX-------------------------------------------
-------------------------------------B------------------XX-------------------------------------------
--E-----------------------B----------B------------------XX---------E---------------------------------
-BBBBBBBB------X---------------------B----------BBBBB--BXXB-------XX------------------X----XXXXXXXXXX
EE------------XX----------------------------------------XX-----E--XX-B----------------XXXXXXX--------
-------------XXX----------------------------------------XX----XX--XX-B---E------------XXXXX----------
------------XXXX---E----E-----------------E---------EEE-XX--E-XX--XX-B-------XXX--E---X--------------
XXXXXXXXX--XXXXXXXXXXXXXXXXXXXXXXXXXXXXX-XXXX-XXXXXXXXXXXXXXXXXXXXXX-XXXXX-XXXXXXXXXXXX------X------X
