-----------------------------------------------------------------------------------------------------
-----------------------------------------------------------------------------------------------------
-----------------------------------------------------------------------------------------------------
--------P--------------------------------------------------------------------------------------------
-------------------CC---------------------------------CCCCCCC----------------------------------------
-------------XXXXXXXXX----X---------------------------XXXXXXX----XX----------------------------------
CCCCC------------------C-----------------------------------------------------------------------------
-------XXX------------XXX----------------------------------------------------------------------------
---------------------------------------------------C----------CC-------------------------------------
-XXXXXX----------------------------------------BB-----------------XX------------------------------B--
----------------------C------------------------E-----P-----------------------------------------------
------XXXXXXX--------XXXXX---------------------------------------------------------------------------
X-------------------------------------------EE-------------------------------------------------------
----------------------------XXXXXXXXXXXXXXXXXXXXXX---XXXXXXXX--------XXXXXXXXXXXXX---X-----XXXXXXXXXX
