-----------------------------------------------------------------------------------------------------
-----------------------------------------------------------------------------------------------------
-------------------------------------------------------------------------------C-----------BBBBBBBBBB
------------------------------------------------------------------------------XXX------------------BB
----X------------------------------------------------------------CCCC-----------------------P------BB
---------------------------------------------------------------XXXXXXX---------------------BPP--E----
----------------E------------------------------------------------------C--E--------CC----------XX----
---------------XX--------------------------------------------X--------XXXXXX-------------------XX----
---------------XX---------------------------------------B---XX---------------------------------XX---E
E--------------XXX------------------------------------------XX-------------CCC-------------BBBBXX--BB
X---------E-------------------------E----------------------XXX--------C------E-----------------XX-EE-
X--------XX-----------------------------X-----------------XXXX-------XXXXXXXXXX-------B--------XX----
X------X-XX----------------------E-----XX-------------------XX------------------------b--------XX----
XXXXXXXXXXXXXXXXXXXXXXXXXXXXXXXXXXXXXXXXXXXXXXXXXXXXXXXXXXXXXX---------------------XXXXXXX-XXXXXXXXXX
