-----------------------------------------------------------------------------------------------------
-----------------------------------------------------------------------------------------------------
-----------------------------------------------------------------------------------------------------
--------------------------CCC------------------------------------------------------------------------
-----------------------------------------------------------------------------------------------------
X----------------------------XC-----------C----C-----------------------------------------------------
--C------------------E------------XXXXXXXXXX---------------------------------------------------------
-XXX----------------XX-----------------------------------E-------------------------------------------
--------------------XX----------------------------------XX-------------------------------------------
--------------------XXXXX------XX------------XX-XXXXXXX-XX-----------------XX-----B-B----------------
-C------------------------------------------------------XX----------E--------------------------------
XXXXXXXX--------------------------------X---------------XX---------XX--------------------------------
--------------------------------------------------------XX---------XX---------------------E----E-----
----------XXXXXXXXXXXXX---------------------------------XXXXXXXXX-XXXXXXXXX-----XXXXXXXX-XXXXXXXXXXXX
