--------------------------------------------------------------------------------------------------------------------
--------------------------------------------------------------------------------------------------------------------
---------------------------------------------------------------------------------X----------------------------------
--------------------------------------------------------------------------------XX----------------------------------
--------------------------------------------------------------------------------XX----------------------------------
-----------------------------------------B----------------------------------BBBBBBPBX-------------------------------
--------------------------------------------------------------------------------------------------------------------
--------------------------------------------------------------------------------------------------------------------
--------------------------------------------------------------------------------------------------------------------
----------------------------------B-B-------------------------------------PB-------------SXX------------------------
-----------------------------------------------------------------------------------------SEX------------------------
-----------------------------SXX---------------------------------------------------------EEX------SX----------------
-------------------------C---EEX-----------------------------------------------C---------EEX------C-----------------
XXXXXXXXXXXXXXXXXXXXX---XXXXXXXXXXXXXXXXXXXXXXXXXXXXXXXXXXXXXXXXXXXXXXXXXXXX--XXX----XXXXXXXXXXXXXXXXXXXXXXXXXXXXXXX
