-----------------------------------------------------------------------------------------------------
-----------------------------------------------------------------------------------------------------
-----------------------------------------------------------------------------------------------------
-----------------------------------------------------------------------------------------------------
-----------------------------------------------------------------------------------------------------
E-E-------P-----------------------B--------------------------BB--------------------------------------
XXXXXXXX----------CCCCC----------------------------E---------------------E------------X--------------
--------------------------------------------------XX--------------------XX---------------------------
-------------XX-----------------------------------XX-------E------------XX--XXXXXXXXX----------------
----------B-XXX-----------B-------B---------------XX------XX------------XXX-------------------E------
------------XXX----------------------E------------XX--E---XX------E--------------------------XX-----E
------------XXX-----------------------------------XX-XX---XX-----XX--------------------------XX----XX
------------XXX-X-------E-----------------E-------XX-XX---XX-----XX---------CCCCC------------XXE---XX
---------XXXXX----XXXXXXXXXXXXXXXXXXXXXXXXXXXXXXXXXXXXXXXXXXXXXXXXXXXXXXXXXXXXXXX-------XXXXXXXXXXXXX
