-----------------------------------------------------------------------------------------------------
-----------------------------------------------------------------------------------------------------
-----------------------------------------------------------------------------------------------------
-----------------------------------------------------------------------------------------------------
------------X----------------------------------------------------------------------------------------
--------------CCCC---XXC---------------------BPBBBBBBBBB---------------------E---B-------------------
--------------------------------------C----C--------------------------------XX-----------------------
----------------------------------------------------------------------------XX-----------------------
----------E-----------------------------------------------------------------XX-----------------------
X--------XX-------XX----XXXXXXXXX------------BBBBBBBBBBB----------------BBBBXXBBBB------BB-----------
X-XX---E-XX-X----------------------------------------------------------------------------------------
X-XX-----XX-----------------------C-----C------------------------------------------------------------
--XX-----XX----------------------XXXXXXXXX--------------------------------------------------E--------
--X--XXXXXX--------------------------------XXXXXXXXXXXXXXXXXXXXXXXXXXXXXXXXXXXXXXXXXXXXXXXXXXXXXXXXXX
