-----------------------------------------------------------------------------------------------------
-----------------------------------------------------------------------------------------------------
-----------------------------------------------------------------------------------------------------
-----------------------------------------C----E-------------------------------------------------B----
---------------------------------------------XXX----------------------------X------CCC---------------
---------------------B--------------------XX----------------B----------------------XXX--------E----E-
-----------------------------------------------------------------------------------------XXXXXXX-----
E----------------------------------------------------XX------------------XXX-------------------------
X--------CCC-----------------------------------------XX-----------------------C----------------------
X----B------CCCC-----B-------CCCCC-----------------XXXX---BPB----------------------------------------
X-------------------------------------------------XXXXX--------------------------XP------------------
X------------------------------------------------XXXXXX----------------------------------------------
X------E----------------------------EE-----------XXXXXX----E-E------------------------------------CCC
XXXXXXXXXXXXXXXXXXXXXXXXXXXXXXXXXXXXXXXX---------XXXXXXXXXXXXXXXX--XXX------------XXXX------------XXX
