---------------------------------------------------------------------------------------------------------------------
---------------------------------------------------------------------------------------------------------------------
---------------------------------------------------------------------------------------------------------------------
---------------------------------------------------------------------------------------------------------------------
---------------------------------------------------------------------------------------------------------------------
----------------------------------C-C-----------CC--------------------C----------------------------------------------
----------------------------------------------C--------------------------C-C-C--------C-----CCC-C-C------------------
-------CC-C-C----CC-CC-CC----C-----C-C---------C------------C---CC-----C--C------------C--CC-----C-------------------
------BB---C-CCC------------------PB------------BBC--CCC-C-----C-------BP---C-----CC-C-----PBB-C---------------------
----------------------C--C-----C---------CC-------------C-----C-----------B----CC---C----P----B----------------------
-----------------------BP--BBBC---------C--C-C-----CC--------------C----------C--C-----------------------------------
------S-----------------------B-P--ES----------SE-BBPP-----ES-----PBP--ES-----------------E--------E-----------------
XXXXXXXXXX-EE----S----------------XXXX--------XXXX--------XXXX--------XXXX---E-----------EXXXX-SSEXXXX---------------
XXXXXXXXXXXXXXXXXXS----SS----S----XXXX--------XXXX----E---XXXX---S----XXXXXXXX--------XXXXXXXXXXXXXXXX---------------
XXXXXXXXXXXXXXXXXXXXXXXXXXXXXX----XXXX--------XXXX----XXXXXXXXXXXX----XXXXXXXX--------XXXXXXXXXXXXXXXX---------------
