-----------------------------------------------------------------------------------------------------
-----------------------------------------------------------------------------------------------------
-----E---------------P-------------------------------------------------------------------------------
-----------------------------------------------------------------------------------------------------
----------------------------------------------------------------------------------------------------C
---------------------------------------------------------------------------BBPBBBBBBBB---------------
-----------------------------------------------------------------------------------------------------
------------------X----------------------------------------------------------------------------------
--------------------B------BB------------------------------------------------------------------------
B-------------------------------E-------------------------------------B--BBBBBBPBBBBBBBB-------------
--------X----------------------XX-----------------------------------------------------------------X--
E------XX------B---------------XX--------------------------------------------------------------------
-----XXXX----X-b---------------XX-EE-E-------E---E--------------E------------------------------------
XXXXXXXXXXXXXXXXXXXXXX-X-XXXXXXXXXXXXXXXXXXXXXXXXXXXXXXXXXXXXXXXXXXXXXXXXXXXXXXX-----XXXXXXXXXXXX---X
