--------------------------------------------------------------------------------------------------------------------
--------------------------------------------------------------------------------------------------------------------
--------------------------------------------------------------------------------------------------------------------
------------------------X-------------------------------------------------------------------------------------------
--------------------------------------------------------------------------------------------------------------------
--------------------------------P--------------------------------------------------------BBBBBBBB-------------------
--------------------------------------------------------------------------------------------------------------------
----------------------------------------------------------------------------------------C---------------------------
--------------------------------------------------------------------------------------------------------------------
----------------PP--------------------------------------------------------------P------BB---------------------------
-------------------------------------X------------------------------------------------------------------------------
------------------------------------------X-------------------------------------------------------------------------
-------------------------------------X----X------------------------------------------------------CC-C---------------
XXXXXXXXXXXXXXXXXXXXX------------------XXXXXXXXXXXXXXXXXXXXXXXXXXXXXXXXXXXXXXXXXXXXXXXXXXXXXXXXXXXXXXXXXXXXXXXXXXXXX
