-----------------------------------------------------------------------------------------------------
-----------------------------------------------------------------------------------------------------
-----------------BBBBBBBBBBB-------------------------------------------------------------------------
-----------------------------------------------------------------------------------------------------
CCCCC------------------------------------------------------------------------------------------------
XXXXX--------------------------------------------------------------------------------------BB------BB
------------------------------C-C-C-C----------------------------------------------------------------
-----------------------------XXXXXXXXX---------------------------------------------------------------
-------------------------E---------------BBBBBBBBBBBBBBBBBPP-CC-------------------------------------E
--------------------E---XX------------------------------------------BB-----------------------------BB
-------------------XX---XX-B-------------------------------------------------------------------------
-------------------XX---XX-B-----------B-------------------------------------------------------------
-------------------XX-E-XX-B-----------b-----------E-------------------------------EE-------------E--
XXXXX-XXXXXXXXXXXXXXXXXXXX-XXXXXXXXXXXXXXXXXXXXXXXXXXXXXXXXXXXXXXXXXXXXXXXXXXXXXXXXXXXXXXXXXXXXXXXXXX
