-----------------------------------------------------------------------------------------------------
-----------------------------------------------------------------------------------------------------
BBBBB---------------------------------------C--------------------------------------------------------
--------------------------------------------XX-------E-----------------------------------------------
-------------------------ECCCCCCCCCCCCC------------XXXX----------------------------------------------
------------XX-----------XXXXXXXXXXXXXXX-------------------X-----------B---------------------------XX
-----------XXX-------------------------------------------------------------------------------------XX
----------XXXX------------------------------------------------------------------------------------XXX
B--------XXXXX---------------------------------XXXX---------------E------------------------------XXXX
------XXXXXXXX---XXXXXXXXXXXXXXXXXXXXXXXXXX----------------------XX----B----E---------------E---EXXXX
----XXXXXXXXXX------------------------------XXXX--------XX-------XX--------XX--------------XX--XXXXXX
----XXXXXXXXXX------------------------------------------XX-------XX------------------------XX--XXXXXX
----XXXXXXXXXX------------------------------------------XX-------XX--------------E---------XX--XXXXXX
XXX-XXXXXXXXXXXXX--------------------------------------XXXXXXXXXXXXXXXXXXXXXXXX-XXXXXXXXXXXXXXXXXXXXX
