---------------------------------------------------------------------------------------------------------------------
---------------------------------------------------------------------------------------------------------------------
---------------------------------------------------------------------------------------------------------------------
---------------------------------------------------------------------------------------------------------------------
---------------------------------------------------------------------------------------------------------------------
-------------------------C---------C----C-------------------------------------------------C--------------------------
-----------C--------------C-C--CC-C-C--------------C------C-C-------------------------------CC-----------------------
-----------------------CC--C--C-------C-------------C-------------------------CC---C-------C----C-C------------------
-------CCCC--C-C----C---BB----------------C--C----C--CCCC--------C---------C-C--C----CCCC-BBBB-----------------------
------C---------CC---C------BB-BBB----------C-----B------C-----C----------C-C-------C----------C---------------------
------------------C------------------------C--C-C-----------------CCCC---------------B--------BB---------------------
------BBBB-------------EE----------SE----E----BBP--------------------P-BB--------------BBBS--------E-----------------
-----------EE---------XXXX---EE---XXXXXXXX-----------S-----SE-----------------------------XXXX----XXXX---------------
XXXXXX----XXXX---S----XXXXXXXXXXXXXXXXXXXX--------XXXX----XXXX---------------ES----EE-----XXXX-EEEXXXXXXXX-----------
XXXXXX----XXXXXXXX----XXXXXXXXXXXXXXXXXXXX--------XXXX----XXXX------------XXXXXXXXXXXX----XXXXXXXXXXXXXXXX-----------
