---------------------------------------------------------------------------------------------------------------------
---------------------------------------------------------------------------------------------------------------------
---------------------------------------------------------------------------------------------------------------------
---------------------------------------------------------------------------------------------------------------------
---------------------------------------------------------------------------------------------------------------------
------------------------------CC-CC-----------C-------------------C-C---------C--------------------------------------
------------------------------------C--------C----------C-----C--------CC-C----CC---CC-------------C-----------------
-----------------------C-----C-----C-C----CCC----C----C---------C-----------CC-----C---------------------------------
-----------CCC-----C--C-CCCCC---BBB-----------B---CC---C---CCC-C-----------C--------B---C----------------------------
------CC------C--CC--------BPB--------C------P-------------------------BPB-----------------C---CC--------------------
--------C--B-B-CC-----------------------------------CC--------------------------------CC-CC-CCC----------------------
------BB-B----B-BB------------E----EE----------SE-B---------------E-----------E----SE-PB--BBB-----SS-----------------
-----------------------------SXXXXXXXX----E---XXXX----S----SS----EXXXX-SE----EXXXXXXXX------------XXXXXXXX-----------
-----------SE----------SE-XXXXXXXXXXXX----XXXXXXXX----XXXXXXXXXXXXXXXXXXXXXXXXXXXXXXXX------------XXXXXXXX-----------
XXXXXX----XXXX--------XXXXXXXXXXXXXXXX----XXXXXXXX----XXXXXXXXXXXXXXXXXXXXXXXXXXXXXXXX------------XXXXXXXX-----------
