-----------------------------------------------------------------------------------------------------
-----------------------------------------------------------------------------------------------------
BBBBBBBBBBBBBBBBBBBBBBBBBBBBBBBBBBBBBBBBBBBBBBB------------------------------------------------------
BBBBBBBBBBBBBBBBBBBB---------------------------------------------------------------------------------
BBBBBBBBBBBBBBBBBBBB---------------------------------------------------------------------------------
BBBBBBBBBBBBBBBBBBBB---BB--------------------E--X-------PBBBBBBBB--------B---------------------------
--------------------------------------------XX--X------------------------------E---------------------
--------------------------------------------XX--X-----------------------------XX---------------------
CCCCC-------P--E----------------------------XX--X-----------------------------XX----------------XXX--
BBBBB-BBBBBBPPBBBBBB---BB-------------------XXB-X---------------------X-XXX---XXX--EE---E---E--------
------BBBBB---BBBBBB--------------E---------XX--X----XX--B--E---------XXX---------XXXXXXXXXXXXXXX----
------BBBBB---BBBBBB-------------XX---------XX--X----XX--b------------XXX---B------------------------
E-E--------CCCBBBBBB------E------XX------E--XX--X----XX--B------------XXX---b------------------------
XXXXXXXXXXXXXXXXXXXXXXXXXXXXXXXXXXXXXX--XXXXXXX-XXXXXXXXXXXXXX-----XXXXXXXXXXXXXX--------------------
