-----------------------------------------------------------------------------------------------------
-----------------------------------------------------------------------------------------------------
--------------------------------------------------------------E--------------------------------------
--------------------------B--------------------------------------------------------------------------
-----------------------------------------------------------------------------------------------------
XX----------------------------------------------------------------------------------------BBB--------
XX---------------------XXX----------------------------------------------C----------------------------
XX---------------------------------------------------------------------------------------------------
XX-------------------------------------------------------------------------E-------------------------
XX--B-B-------EEE-----------------------------BB-----------------E----X---XX-------------------------
XX-------XXXXXXXXXXXXXXX-----------------------------------------E----X---XX---------E-----E---------
XX--------------------------------------------------------------------X---XX--------XX----XX---------
XX---------------------------------E-----X---------E----------XX------X---XX--------XX----XX---------
XXXXXXXX--------------------XXXXXXXXXXXXXXXXXXXXXXXXXXXXXXXXXXXXXXX---XXXXXXXXXXXXXXXXXXXXXXXXXXXXXXX
