---------------------------------------------------------------------------------------------------------------------
---------------------------------------------------------------------------------------------------------------------
---------------------------------------------------------------------------------------------------------------------
---------------------------------------------------------------------------------------------------------------------
---------------------------------------------------------------------------------------------------------------------
----------------------C----------------------------C-C---------------------------------C-C---------------------------
--------------------------------------------------C-C-C-C---------CC--------CC-----C--C------------------------------
------CCC--------------CC--C--------------------C---------------C------C--CC--------CC-------------------------------
------BBBB-C-----C------PBC-CC-C---C-----CC--C---C-BBB---C----CC-C--CCC--CP-B--C------BB-BC-CC-----------------------
----------C-CC-C---C-C----BBBBBBPBC-CCC-------CC------BBB---CC---------------------------------C-CC------------------
----------------------------------------------------------C-----------PBPB--------------------C-C--------------------
------E---BBBBBB-------SE----------------------------E----------------------E------SE----E---------------------------
XXXXXXXXXX------------XXXX---EE-------------------XXXXE----------SE-------XXXX----XXXXXXXXE--------------------------
XXXXXXXXXX--------E---XXXXXXXXXXXX--------E----EE-XXXXXXXX----XXXXXXXX-EE-XXXXS---XXXXXXXXXXXX----SS-----------------
XXXXXXXXXX--------XXXXXXXXXXXXXXXX--------XXXXXXXXXXXXXXXX----XXXXXXXXXXXXXXXXXXXXXXXXXXXXXXXX----XXXXXXXX-----------
