---------------------------------------------------------------------------------------------------------------------
---------------------------------------------------------------------------------------------------------------------
---------------------------------------------------------------------------------------------------------------------
---------------------------------------------------------------------------------------------------------------------
---------------------------------------------------------------------------------------------------------------------
--------------------------C------------C-C--------------------------------C-C----------------------------------------
--------------C-CC---------CCC--C-CC--C------------------------C-----------C-----------------------------------------
---------------C--------------CC-C--CC---------------C------C-C---C----------C------C-------C------------------------
------CCC----C-----C---CC--PBP-------------C-------------C---------C-C-CC--B------C-----CC---C--C-C------------------
------------C--B--C-----------B-B---------C-C-CC--BBBP------------B--P---C-----------C-C--B-BBC--C-------------------
-----------C--------C-C--C-----------------------C--------------------BBBB----CCCC----C--------C---------------------
-----------BPB---------------E----E-E----E-----------------------S-----------EP---------BB---------------------------
----------------E---------XXXXS---XXXXXXXX-----------ES-------XXXXS-------XXXX-------------E----------XXXX-----------
------E-------XXXX--------XXXXXXXXXXXXXXXX--------XXXXXXXX-EE-XXXXXXXX-EE-XXXX-----SE-----XXXX--------XXXX-----------
XXXXXXXXXX----XXXX--------XXXXXXXXXXXXXXXX--------XXXXXXXXXXXXXXXXXXXXXXXXXXXX----XXXX----XXXX--------XXXX-----------
