---------------------------------------------------------------------------------------------------------------------
---------------------------------------------------------------------------------------------------------------------
---------------------------------------------------------------------------------------------------------------------
---------------------------------------------------------------------------------------------------------------------
---------------------------------------------------------------------------------------------------------------------
------------------------------C-CC------C---------------------------------------------------------CC-----------------
------C-CC----------------------------C--C-------------------------C-------C-----C-----------------------------------
-------------------C----CC-------------C---------C---C----------C---C-C---C-CC--C------------C-----------------------
-------C----C----C--------C----B---------P----CCC------C-----CC--C---C-C------CC----C------C----CC-------------------
----------------C-C--C------CC-----C------CC-CBBP-C---C-C------C----PB----B-------C------C---------------------------
----------B-BB-C---------P-----------C----BBBB----BB------------------BPBP-----------CC-C-P---CC---------------------
--------------B-----------PPBPE----------E----------------------------------------BP----PB--------SS-----------------
------E-----------------------XXXX----XXXX-----ES-----------------E----------EE-------------------XXXX---------------
XXXXXXXXXX-SE-----S----EE-----XXXX----XXXXS---XXXX---EE----------EXXXX-SS-XXXXXXXX--------E-------XXXXXXXX-----------
XXXXXXXXXXXXXX----XXXXXXXX----XXXX----XXXXXXXXXXXXXXXXXXXX----XXXXXXXXXXXXXXXXXXXX--------XXXX----XXXXXXXX-----------
