---------------------------------------------------------------------------------------------------------------------
---------------------------------------------------------------------------------------------------------------------
---------------------------------------------------------------------------------------------------------------------
---------------------------------------------------------------------------------------------------------------------
---------------------------------------------------------------------------------------------------------------------
-----------------------------------------------C-CC--C------------C-------------CC-----------------------------------
------C--------C-----------------------------------C------------C--C---C-CC-C-CC-----------C-------------------------
----------------C--C-------C-C----C----C-C-C----C---C-C--C-----C-C---------C------C---------------C------------------
--------C--CC----C------C-C-C-CC----CC-------CB-BBB-B--C------------B-BPBB----------------C-CCCC---C-----------------
-------BBB---CP---C------CPBPB---C----C---C-------------------------------PBBB-----C-C---C-B-----C-------------------
----------BBPB------------------C------------B--------------C------------------------BC------------------------------
-----------------------------------------------EE----E------------S----EE-----E-------P-BB---------------------------
------E----------E-----------E----------------XXXXXXXXE----------EXXXXXXXX---EXXXX--------S-------SE-----------------
XXXXXXXXXX-EE-XXXXE----SE-XXXX-----ES----EE---XXXXXXXXXXXX----XXXXXXXXXXXXXXXXXXXX-ES-----XXXX-E-EXXXX---------------
XXXXXXXXXXXXXXXXXXXXXXXXXXXXXX----XXXXXXXXXXXXXXXXXXXXXXXX----XXXXXXXXXXXXXXXXXXXXXXXX----XXXXXXXXXXXX---------------
