---------------------------------------------------------------------------------------------------------------------
---------------------------------------------------------------------------------------------------------------------
---------------------------------------------------------------------------------------------------------------------
---------------------------------------------------------------------------------------------------------------------
---------------------------------------------------------------------------------------------------------------------
------C--------------CC-C--------------------------------------------------CCC---------------------------------------
-------CC------C---C---C-C-----CC--C------------CC----------------------CC------------C---C---CCC--------------------
---------C-------CC----------CC---C-C--------------C-C-CCC------------CC--C-------------C--CCC-----C-----------------
-------BPB----C-C-------BBC------C-----C------CC-----------C-C------BB----BB--------CC-C----------C------------------
-----------CC--------------C--BB----------CC-C---BC-C-----C---CC------BBP-------C--C--B-PB---------------------------
----------C---------------B-PB----------C---C-----BBB-----------CC---------------------------------------------------
------S---BBBB----E----SE-------------------BB--------E-----------E----------E------P-----E----ESE-------------------
XXXXXXXXXX-------SXXXXXXXX----S----EE----------EE-----XXXX--------XXXX-SS-XXXX-----------EXXXXXXXX-------------------
XXXXXXXXXX----XXXXXXXXXXXX---EXXXXXXXX--------XXXX---EXXXX--------XXXXXXXXXXXX--------XXXXXXXXXXXXXXXX---------------
XXXXXXXXXX----XXXXXXXXXXXXXXXXXXXXXXXX--------XXXXXXXXXXXX--------XXXXXXXXXXXX--------XXXXXXXXXXXXXXXX---------------
