--------------------------------------------------------------------------------------------------------------------
--------------------------------------------------------------------------------------------------------------------
--------------------------------------------------------------------------------------------------------------------
--------------------------------------------------------------------------------------------------------------------
--------------------------------------------------------------------------------------------------------------------
---------------BB---BBB---------------------------------------------------BB-BBBB-----------------BBB---------------
--------------------------------------------------------------------------------------------------------------------
--------------------------------------------------------------------------------------------------------------------
--------------------------------------------------------------------------------------------------------------------
---------------------------P--------XX-XX------------------------------------BB-------------BPB---------------------
-----------------------------------XXX--XXX--------------------------------------------ESX--------------------------
------------------------------SXXXXXXXXXXXX--------------------------------------------EEX--------------------------
------------------------------EEXXXXXXXXXXX--------------------------------------------EEX-C------------------------
XXXXXXXXXXXXXXXXXXXXXXXXXXXXXXXXXXXXXXXXXXXXXXXXXXXXXXXXXXXXXXXXXXXXXXXXXXXXXXXXXXXXXXXXXXXXXXXXXXXXXXXXXXXXXXXXXXXX
