---------------------------------------------------------------------------------------------------------------------
---------------------------------------------------------------------------------------------------------------------
---------------------------------------------------------------------------------------------------------------------
---------------------------------------------------------------------------------------------------------------------
---------------------------------------------------------------------------------------------------------------------
----------------------C--C-----CC--C------------------CC-CCC-C-------------------------------------------------------
-------------------C----C-----C---C------------------------------C---------------------------C---C-------------------
--------------C------------------C--CC-----CCC----------C---C-CCC--CC---C-------------------C--C---------------------
----------C---------C--------CBBBBB-PB--------C-CCCC--B--B-------PC----C--------CC--CC----CC--C----------------------
------CC-------CC----------C------------------------BB----------------C-----C-C-------C----PB----B-------------------
-----------C-CB-------------C------------------C------------------BPB-PPB-CC-C---------CCC---------------------------
----------PPBB---------EE-----S----EE----S------------E----ES----E------------------PBBBB----------------------------
------------------S---XXXX----XXXXXXXXXXXXS----------SXXXXXXXXXXXX------------------------E----EESSE-----------------
-----------------SXXXXXXXX----XXXXXXXXXXXXXXXX----XXXXXXXXXXXXXXXXE----EE-----------------XXXXXXXXXXXXXXXX-----------
XXXXXX--------XXXXXXXXXXXX----XXXXXXXXXXXXXXXX----XXXXXXXXXXXXXXXXXXXXXXXX----------------XXXXXXXXXXXXXXXX-----------
