--------------------------------------------------------------------------------------------------------------------
--------------------------------------------------------------------------------------------------------------------
--------------------------------------------------------------------------------------------------------------------
----------------------XX--------------------------------------------------------------------------------------------
----------------------X-------------------------------------------------------------------------C-------------------
------------------BBBPXXXX----------BBBBBBB-------------------------------B----P--------------BBBBBBB---------------
--------------------------------------------------------------------------------------------------------------------
-----------------C--------------------------------------------------------------------------------------------------
--------------------------------------------------------------------------------------------------------------------
----------------PB------B----------------------------------------------------BB--------P----BBB---------------------
--------------------------------E-----------------------------------------------------------------------------------
--------------------------------E-----------------------------------------------------------------------------------
---------------------C-C----C-C-E-------C----------------------------------------------E---------C------------------
XXXXXXXXXXXXXXXXXXXXXXXX--XXXXXXXXXXXXXXXXXXXXXXXXXXXXXXXXXXXXXXXXXXXXXXXXXXXXXXXXXXXXXXXXXXXXXXXXXXXXXXXXXXXXXXXXXX
