-----------------------------------------------------------------------------------------------------
-----------------------------------------------------------------------------------------------------
-C---------------------------------CCCCCCC-----------------------------------------------------------
XXX--------------------------------------------------------------------------------------------------
-----------------------------------------------------------------------------------------------------
------------------------------XXCC-------------------------------------------------------------------
--------------------------------------------XXX------------------------------------------------------
-----------------------------------------------------------------------------------------------------
---------------------------------XXXXXXXXXX-------------E-----------E--------------------------------
-------------------------B-----------------------------XX--------B-XX-------------E------------------
-------------------------------------------------------XX----------XX-----E------XX------------------
X------------------------------------------------------XX----------XX----XX------XX-----------------X
-------------------------------------------------------XX----------XX----XX------XX----------------XX
-----XX--XXXXXXXXXXXXXXXXXXX--------------------XXXXXXXXXXXXXXXXXXXXXXXXXXXXXXXXXXXXXX----XXX-XXXXXXX
