-----------------------------------------------------------------------------------------------------
-----------------------------------------------------------------------------------------------------
--------------------------------------------------------------------------------------------------E--
------------------------------------------------------------------------C----------------------------
-----------------------------------------------------------------------------------------------------
-------------------BBBB--------------------------------B-----------------X-C-------------------------
XXXXXX------------------------------CCCC-------------------------------------------------------------
-----------------------------------------------------------------------------------------------------
-------CC-----------------X------------------------E----------------------XXXX----BB------------E----
-------------------------XX-----------------------XX-------------------------------------------XX----
--------------------E----XX-----------------------XX----E-E------------------------------------XX----
X-X----------------------XX-----------------------XX---XXXX--XX--------------------------------XX---X
-----------X-------------XX---E--------------X----XX---XXXX--XX------E------------BBBBB--------XX-XXX
----XXXXXXXXXXXXXXXXXXXX-XXXXXXXXXX-XXXXXXXXXXXXXXXXXXXXXXXXXXXXXXXXXXX---------------XXXXXXXXXXXXXXX
