---------------------------------------------------------------------------------------------------------------------
---------------------------------------------------------------------------------------------------------------------
---------------------------------------------------------------------------------------------------------------------
---------------------------------------------------------------------------------------------------------------------
---------------------------------------------------------------------------------------------------------------------
---------C----------------------------------------------------------------CCCC--------------------CC-----------------
------------------C----C-----C----------------------C--C----------------------CCC-----C--C---------------------------
-------------------C-CC-CC-------C----CCC------CC-C--C---C---C----------C--------C---C-C---C-----C-------------------
--------------C-----C---B-BPP---C--CCC---C-C--C-------C-C--CC--C--------------------C---C---CCC----------------------
---------------C-C------------C---C----------C---B-BB---------C---CC--BBB----------C--BBPB-----C---------------------
------------C---C-------------PP----B-----C----------------------P-----------------B-B----BBPB-----------------------
------E-----BB-B-------EE----E------------------------------------PBB--------EE-------------------EE-----------------
XXXXXXXXXX--------E---XXXXXXXX-----------E-----SS----EE----------------SE-XXXXXXXX-------E--------XXXX---------------
XXXXXXXXXX--------XXXXXXXXXXXXE----EE-XXXX----XXXXXXXXXXXX-EE----S----XXXXXXXXXXXX-EE-XXXXE----EEEXXXX---------------
XXXXXXXXXX--------XXXXXXXXXXXXXXXXXXXXXXXX----XXXXXXXXXXXXXXXXXXXX----XXXXXXXXXXXXXXXXXXXXXXXXXXXXXXXXXXXX-----------
