---------------------------------------------------------------------------------------------------------------------
---------------------------------------------------------------------------------------------------------------------
---------------------------------------------------------------------------------------------------------------------
---------------------------------------------------------------------------------------------------------------------
---------------------------------------------------------------------------------------------------------------------
----------------------------------------------------------------------C-C----------------------CC--------------------
------------C---C-----------------------------------------CC-------------C-------------C-----------------------------
-----------C-------------C-----------------C--------C----------------------------C----C-C----------C-----------------
--------C-----CC--CC-C--C---------CC--C-------CCC----C--C------C------BBP---C--C----CC---C-C-C-----------------------
------C---BPBB---------C---------C---C---C---C-----C---C-C------CC-C------C--C----CC--BBBP---------------------------
--------------------------C-CCC-----C---C----B---CBBB-------------C-C----------------------B-------------------------
---------------------------BBB-BBBPB----------BPBB-----------------PBP-ES----------------------EEE-------------------
-----------ES----E-----------------------------------------ES---------XXXX----S----------E----XXXX-------------------
XXXXXX----XXXXXXXXE----ES-----------------E----------SE---XXXX--------XXXX----XXXX----XXXXS---XXXX-------------------
XXXXXX----XXXXXXXXXXXXXXXX----------------XXXX----XXXXXXXXXXXX--------XXXX----XXXX----XXXXXXXXXXXXXXXX---------------
