--------------------------------------------------------------------------------------------------------------------
--------------------------------------------------------------------------------------------------------------------
--------------------------------------------------------------------------------------------------------------------
--------------------------------------------------------------------------------------------------------------------
--------------------------------------------------------------------------------------------------------------------
------------------BBBP---------------------------------------------------BBBBBBBBBP---------------------------------
--------------------------------------------------------------------------------------------------------------------
--------------------------------------------------------------------------------------------------------------------
--------------------------------------------------------------------------------------------------------------------
--------------------P----------------BB-----------------------------------------------------XXX---------------------
--------------------------------------------------------------------------------------------XX----------------------
-------------------------------E-------------------------------------------------------SXXXXXX----SXX---------------
----------------C-------CC-C-------------------------------------------------------C---EX-XXX-----EEX---------------
XXXXXXXXXXXXXXXXXXXXXXXXXXXXXXXXXXXXXXXXXXXXXXXXXXXXXXXXXXXXXXXXXXXXXXXXXXXXXXXXXXXXXXXXXXXXXXXXXXXXXXXXXXXXXXXXXXXX
