--------------------------------------------------------------------------------------------------------------------
--------------------------------------------------------------------------------------------------------------------
--------------------------------------------------------------------------------------------------------------------
--------------------------------------------------------------------------------------------------------------------
--------------------------------------------------------------------------------------------------------------------
------------------BBBP------------------------------------------------------BB--------------------------------------
--------------------------------------------------------------------------------------------------------------------
---------------------------------------------------------------------------C----------------------------------------
--------------------------------------------------------------------------------------------------------------------
----------------PB------BP--------XXXX--X---------------------------------BB--P--PB-----B----B-B----B---------------
--------------------------------XXXX-X--XX--------------------------------------------------------------------------
-------------------------------XXXXX-XXXXX------------------------------------------------SX------------------------
---------------------C--------XXXXXX-XXXXX-------------------------------------------C----EX------------------------
XXXXXXXXXXXXXXXXXX---XXX---XXXXXXXXXXXXXXXXXXXXXXXXXXXXXXXXXXXXXXXXXXXXXXXXXXXXXXXXXXXXXXXXXXXXXXXXXXXXXXXXXXXXXXXXX
