-----------------------------------------------------------------------------------------------------
-----------------------------------------------------------------------------------------------------
-----BBBBBBBBBBBBBBBBBBBBBBBBBBBBBBBBBBBBBBBB--------------------------------------------------------
-----------------------------------------------------------------------------------------------------
-------------------------------------------------------CC--------------------------------------------
----------E--------------------------------------BB--------------------------------------------------
---------XX----------------------------------------------------------------XX------------------------
-E-------XX------------------B-----------------------------------------------------------------------
XX-------XX---E--------------B---E-------------------------------------------------------------------
XX-------XX--XX--------------B--XX--------------XXXX----XXXXX-XXXXXXXXXXX----------------------------
XX-------XX--XX-----------------XX----------XXXXXX---------------------------------------------------
XX-------XX--XX-----------------XX---------XXXXX-----------------------------------------------------
XX-------XX--XX---------EE------XX-------XXXXX---------------------------------EE----------E---------
XXXXXXXXXXXXXXXXXXXXXXXXXXXXXXXXXX----XXXXXXX-----XXX-------------------------XXXXXXXXXXXXXXXXXXXXXXX
