---------------------------------------------------------------------------------------------------------------------
---------------------------------------------------------------------------------------------------------------------
---------------------------------------------------------------------------------------------------------------------
---------------------------------------------------------------------------------------------------------------------
---------------------------------------------------------------------------------------------------------------------
-----------C---------------------------C--------------------------------------C--------------------------------------
-------CC----C--C---C----------------C----C----C----------C----------------------C----C------C---C-------------------
------C--C--C--C-----------CC--C-CC-C-C--C-C-----C-----------C-----------C---------CC--CC-----C----------------------
----------PPBPC--C-----C-C--------P---------CCC-C--C--C----------------C----CC----C------CCCC------------------------
-------PBP----B---------C----CC-C---------------BBC-C--CCC----C-CC-C---B-------------CB-B----------C-----------------
----------------------------BB-BBB-------------------C--------------------CC---------B-------------------------------
-----------EE-----E----------------EE----E--------B------------BBBBB-B-----B--E----------------EEE-------------------
------E---XXXX---EXXXX------------XXXXXXXXE----SE----------ES----------SE-----XXXX-------SS---XXXX-------------------
XXXXXXXXXXXXXXXXXXXXXX-------SS---XXXXXXXXXXXXXXXX--------XXXX--------XXXX----XXXX-SE-XXXXXXXXXXXX-------------------
XXXXXXXXXXXXXXXXXXXXXX----XXXXXXXXXXXXXXXXXXXXXXXX--------XXXX--------XXXX----XXXXXXXXXXXXXXXXXXXX----XXXX-----------
