-----------------------------------------------------------------------------------------------------
-----------------------------------------------------------------------------------------------------
BBBBBBBBBBBBBBBBBBBBBBBBBBBBBBBBBBBBBBBBBBBBBBBBBBBBBBBBBBBBBBBBBBBBB--------------------------------
----------------BBB-------BBBBBBB-----------------BBBB-----------------------------------------------
P---------------BBB-------BBBBBBB-----------------BBBB-----------------------------------------------
PP---------------BB---------B-----------E-------BB----------------------E-----------P----------------
-----------------BB---------B----------XX-------BB---------------------XX----------------------------
-----------------BB---------B----------XX-------BB---------------------XX----------------------------
----------------CBB-------CCBCCCPP-----XX---E---BB-------E-------------XXX---------------------------
BBBB------------BBB-----E-BBBBBBB-----BXX--XX---BBBBBB--XX---------BB---------------B----------------
---------------------E-XX--------------XX--XX-----BBBB--XX-----------------E-------------------------
--------------------XX-XX--------------XX--XX-----BBBB--XX----------------XX-------------------------
--------------E---E-XX-XX-----E------E-XX--XX----E------XX-----E----------XX-------------X---X------E
XXXXXXXXXXXXXXXXXXXXXXXXXXXXXXXXXXXXXXXXXXXXX--XXXXXXXXXXX--XXXXXXXXX-XXXXXXXX--XXXXXXXXXXXXXXXXXXXXX
