--------------------------------------------------------------------------------------------------------------------
--------------------------------------------------------------------------------------------------------------------
--------------------------------------------------------------------------------------------------------------------
--------------------------------------------------------------------------------------------------------------------
--------------------------------------------------------------------------------------------------------------------
-------------------B------------------------------------------------------------------------------------------------
--------------------------------------------------------------------------------------------------------------------
--------------------------------------------------------------------------------------------------------------------
--------------------------------------------------------------------------------------------------------------------
-----------------P-----------------XXX---XX--------------------------------------------B-----BBB----B---------------
--------------------------------XX-XXX--XXX-------------------------------------------------------------------------
-------------------------------XXXXXXX--XXX-----------------------------------------------SXX-----------------------
-------------------------------XXXXXXX--XXX---------------------------------------C-CC----EEX------C----------------
XXXXXXXXXXXXXXXXXX----XX--------XXXXXXXXXXXXXXXXXXXXXXXXXXXXXXXXXXXXXXXXXXXXXXXXXXXXXXXXXXXXXXXXXXXXXXXXXXXXXXXXXXXX
