-----------------------------------------------------------------------------------------------------
-----------------------------------------------------------------------------------------------------
-----------------------------------------------------------------------------------------------------
-----------------------------------------------------------------------------------------------------
E----------------------------------------------------------------------------------------------------
BB----------------------------------BBBBBBB--B-------------------------B-----------------------------
-----------------------------------------------------------------------------------CCCCCC------------
----------------------------------------------------------------X------------------------------------
-----------------------------------B-------EE--------------------------------------------------------
BB---------XXXXX--------------------------------------BBBB-------------------------------------------
------------------E------E---------------------------------------------------------------------------
------------------------XX---------------------------------------------------------------------------
-----EE--E----------E---XX---------------------------------------------------------------------E-----
XXXXXXXXXXX----XXX-XXXXXXXXXXXXXXXXXX---------------XXXXXXXXXXX-XXXXXXXXXXXXXXX-XXXXXXXXXXXXXXXXXXXX-
