---------------------------------------------------------------------------------------------------------------------
---------------------------------------------------------------------------------------------------------------------
---------------------------------------------------------------------------------------------------------------------
---------------------------------------------------------------------------------------------------------------------
---------------------------------------------------------------------------------------------------------------------
-----------C-------------------------------------------C-C----CCC--------------C-------------------------------------
------C-----C----------------------------------------C--C--------C-CC------C--C--C-----C-C--C------------------------
----------C---------------CC-------------------CC---C-C---C----------C------------C-C--------CC--C-------------------
----------BBPB---C------C------CCCC--C-C-----C--------------------C------C--CC-------C--C-BBPBP----C-----------------
--------------C-----C----CPBBB--------C-C-----C--CPBB-------C-----BBBB--C-------------BBP----------------------------
--------------B---CC--CC------B----------C-----BB--------------------------------------------------------------------
-----------SE---------------------------BBBBBB--------E----------S----BBPB----E-----------S----E-E-------------------
------E---XXXX---------------E-----EE----------------EXXXX----XXXXE----------SXXXX-------EXXXXXXXX-E--XXXX-----------
XXXXXXXXXXXXXX---E--------XXXXE---XXXX---------ES-XXXXXXXX-EE-XXXXXXXX----XXXXXXXX-EE-XXXXXXXXXXXXXXXXXXXX-----------
XXXXXXXXXXXXXXXXXX--------XXXXXXXXXXXX--------XXXXXXXXXXXXXXXXXXXXXXXX----XXXXXXXXXXXXXXXXXXXXXXXXXXXXXXXX-----------
