-----------------------------------------------------------------------------------------------------
-----------------------------------------------------------------------------------------------------
-----------------------------------------------------------------------------------------------------
--------------------------------------------------------------------------------------E--------------
---------------------------CC--------------------------------------------------------XXXX------------
BBBB------PB-------------------------------------------------BBBBB-----------------------------------
-------------------------------------CC---------------------------------------------------XXXX-------
B----------------------------------------------------------------------------------XX-----C----------
-B------------------------------XXXX---------------CC---------------BB--------E----------------------
--BB--------E---------------XXX----------------------CC----------------------XX----------------------
-----------XX----------------------------------------------------------------XX----------------XXX---
-----------XX----------------------------------------------------------------XX----------------------
-----------XXE-----------------X---------E---------------E----------BBBBBBB--XX----------------------
XXXXXXXXXXXXXXXXXXXXX-XXXX-----------XXXXXX-XXXXXXXXXXXXXXXXXX------------XXXXXXX-------------------X
