---------------------------------------------------------------------------------------------------------------------
---------------------------------------------------------------------------------------------------------------------
---------------------------------------------------------------------------------------------------------------------
---------------------------------------------------------------------------------------------------------------------
---------------------------------------------------------------------------------------------------------------------
----------------------------------------------------C------C-----C-----------------CC--------------------------------
----------------------------C--C------------------------C-----------------C----------C-------------------------------
------C---------C---------C-----CC----C---CC------CC--C-------C---C-----C--C-----------C----------C------------------
--------C---C-CC-CCC-------C-CC----C---CC----C-C--BBBB-C-C-------B-CC--------C--C---PP-----------C-------------------
-------BPBCC-C-----------CBBBBBBPB--C---------C-C--------------------------------C------CCC-C-C----------------------
-----------BB---------CC----------C--C----------------------------BB-BB-------C--------BPB---C-CC--------------------
-----------------------------------------------BPB---E-----ES----E-----------------S-S----BPPB-----------------------
------E----------EE----------EE-----------E-------XXXXE---XXXXXXXX-----------E----XXXX-------------------------------
XXXXXXXXXX-SS-XXXXXXXX----XXXXXXXX-------EXXXX----XXXXXXXXXXXXXXXXE----EE-XXXX----XXXX---S--------XXXX---------------
XXXXXXXXXXXXXXXXXXXXXX----XXXXXXXX----XXXXXXXX----XXXXXXXXXXXXXXXXXXXXXXXXXXXX----XXXXXXXX--------XXXXXXXX-----------
