--------------------------------------------------------------------------------------------------------------------
--------------------------------------------------------------------------------------------------------------------
--------------------------------------------------------------------------------------------------------------------
--------------------------------------------------------------------------------------------------------------------
--------------------------------------------------------------------------------------------------------------------
--------------------------------------------------------------------------------------------------------------------
--------------------------------------------------------------------------------------------------------------------
--------------------------------------------------------------------------------------------------------------------
--------------------------------------------------------------------------------------------------------------------
-------------------------------------X------------------------------------P-------B------------B--------------------
------------------------------------XX---XX-----------------------------------------------XX------------------------
--------------------------------XX--XX---XX-----------------------------------------------XX------------------------
------------------------CC-------XXX-X---XX---------------------------------------------C-XXX-----------------------
XXXXXXXXXXXXXXXXXXXXXXXXXXXXXXXXXXXXXX-XXXXXXXXXXXXXXXXXXXXXXXXXXXXXXXXXXXX-----X----------X-X--XXXXXXXXXXXXXXXXXXXX
