-----------------------------------------------------------------------------------------------------
-----------------------------------------------------------------------------------------------------
-----------------------------------------------------------------------------------------------------
-C---------------------------------------------------------------X-----------------------------------
XXX--------------------------------------------------------------X-----------------------------------
--------------------------------X------BBBBBB--------------------X-------------------------B---------
------------------XXXXX----BB---X--------------------------------X-----------------------------------
-------------------------------XX---------------------C----------X-----------------------------------
-------------------------------XX----------------------E---------X-----------------------------------
-----------E-E----------------XXX------PBBBBBBBBB--BBBBBB--------X--------B----------BBBBBBBBB-------
--------XXXXXXXXXXX----------XXXX--------------------------------X-----------------------------------
----------------------------XXXXX-----------------------E--------X-----------------------------------
---------------------------XXXXXX-E-----------------------E------X-------------E-XXX-E---------------
XXXXXX----------------XXXX-XXXXXXXXXXXXX---XXXXXXXXXXXXXXXXXXXXXXXXXXXXXXXXXXXXXXXXXXXXXXXXXXXXXX---X
