--------------------------------------------------------------------------------------------------------------------
--------------------------------------------------------------------------------------------------------------------
--------------------------------------------------------------------------------------------------------------------
--------------------------------------------------------------------------------------------------------------------
--------------------------------------------------------------------------------------------------------------------
--------------------------------------------------------------------------------------------------------------------
--------------------------------------------------------------------------------------------------------------------
--------------------------------------------------------------------------------------------------------------------
--------------------------------------------------------------------------------------------------------------------
-------------------------------SXX----XX-------------------------------------------------------B--------------------
-------------------------------EEX----XX----------------------------------------------------------------------------
-------------------------------EEX---XXXX-------------------------------------------------XX------------------------
--------------------------C----EEX-XXXXXX-----------------------------------------------C--XX-------X---------------
XXXXXXXXXXXXXXXXXXXXXXXXXXXXXXXXXXXXXXXXXXXXXXXXXXXXXXXXXXXXXXXXXXXXXXXXXXXXXX----------XXXXXXXX-XXXXXXXXXXXXXXXXXXX
