-----------------------------------------------------------------------------------------------------
-----------------------------------------------------------------------------------------------------
BBBBBBBBBBBBBBBBBBBBBBBBBBPBBBBBBBBBBBBBBBBBBBBBBBBBBBBBBBBBBBBBBBBBBBBBBBBBBBBBBBBBBBBBBBBBBBBBBBBBB
---------------------------------------BBBBBBBBBBBBBBBBBBBBBBBBBBBBBBB----------------------BBBBBBBBB
---------------------------------------BBBBBBBBBBBBBBBBBBBBBBBBBBBBBBB----------------------BBBBBBBBB
---BB----------------CCCCCC------------BBBBBBBBBBBBBBBBBBBBBBBBBBBBBBB----------E-----------BBBBBBBBB
-------------------------------------------------------------------------------XX--------------------
---------------------BBBBBB----------------------------------------------------XX--------------------
---------------------BBBBBB-------E----------P--------------------------E------XX---E----------------
B--BB---------E------------------XX------BBBBPPBBBBBBBBBBBBBBBBBBBBBBB-XX------XX--XX---------BBBBBBB
-------------XX--------------E---XX------BBB---BBBBBBBBBBBBBBBBBBBBBBB-XX------XX--XX---------BBBBBBB
-------X-----XX--X----------XX---XX------BBB---BBBBBBBBBBBBBBBBBBBBBBB-XX------XX--XX---------BBBBBBB
EE----XX-----XX-XX-E--------XX---XX---------CCCBBBBBBBBBBBBBBBBBBBBBBB-XX--EEE-XX--XX----------------
XXXXXXXXXXXXXXXXXXXXXXXXXXXXXXXXXXXXXX--XXXXXXXXXXXXXXXXXXXXXXXXXXXXXXXXXXXXXXXXXX-XX--------XXXXXXXX
