---------------------------------------------------------------------------------------------------------------------
---------------------------------------------------------------------------------------------------------------------
---------------------------------------------------------------------------------------------------------------------
---------------------------------------------------------------------------------------------------------------------
---------------------------------------------------------------------------------------------------------------------
--------------------------------------C-------C-----------------C---C------------------CCC---------------------------
------------------------CC--------CCC----------------C-----CCCC--C-----C-------CC----C----------CC-------------------
------CCC--C-----------C-----------------C----------------C----C------C-C---------CCC-----C--C-C---------------------
-------BBBC-CC---CCCCCC---C-C--C---------------PP---C--C-C----------BP-------C---------PBB-PB-C----------------------
------------------------BB-C-C-------------C------BBBB--C-------------BBPPC------------------------------------------
-----------B--CC-----------B-B---C--------C-C-------------------------------C----------------------C-----------------
------E-----------------------PB---EE----EP--B-SE-----B----------ES-----------E----EE----SE--------------------------
XXXXXXXXXX-------------SE---------XXXXXXXX----XXXX---S-----ES-XXXXXXXX-EE-----XXXXXXXXXXXXXXXX-SEE-------------------
XXXXXXXXXX-EE-----E---XXXX---E----XXXXXXXX----XXXXXXXX----XXXXXXXXXXXXXXXX----XXXXXXXXXXXXXXXXXXXX----XXXX-----------
XXXXXXXXXXXXXX----XXXXXXXXXXXX----XXXXXXXX----XXXXXXXX----XXXXXXXXXXXXXXXX----XXXXXXXXXXXXXXXXXXXX----XXXX-----------
