-----------------------------------------------------------------------------------------------------
-----------------------------------------------------------------------------------------------------
-----------------------------------------------------------------------------------------------------
-----------------------------------------------------------------------------------------------------
-----------------------------------------------------------------------------------------------------
------------------------------------------------------B------BBBB------------------------------------
---------------------------CC--------BB--------------------------------------------------------------
---------C--------------------------------XXBB--C----------------------------------------------------
-----------------------------------------XXXX----------------BBBB--------------------------------P---
PB-----EB----X--------------------------EXXXX-BB------B----------------------------------------------
------------XXXX-----------------------XXXXXX------------------------E-------------------------E-----
------------XXXX----------------------XXXXXXX--BBB------------------XX-------------------------------
---E--------XX-----------------------XXXXXXXX-----------------------XX---------E-------EE------------
XXXXXXXXXXXXXX------XXX----XXXXXXXXX-XXXXXXX------X-XXXXXXX------XXXXXXXXXXXXXXXXXXXXXXXXXXXXXXXXXXXX
