---------------------------------------------------------------------------------------------------------------------
---------------------------------------------------------------------------------------------------------------------
---------------------------------------------------------------------------------------------------------------------
---------------------------------------------------------------------------------------------------------------------
---------------------------------------------------------------------------------------------------------------------
--------------------CC-----------------------------------------------------------------------------C-----------------
-----------C--CCC-CC------CC----------C-----C-C---------C-----------C-------------------------CC---------------------
-------------C--------------CC-CC-C----CCCCC---C-C----C--C-------CC--C-------C--------------CC-----------------------
------------C----C-------C----C----C---------C------------CC---CC----------------C--C--C---C-------------------------
----------BPB-B-P-----C-C-BBBB---C---C--------BBBB--C-B-----------B-BB---C-C---C--CC-C-------------------------------
------------------------------PBBB----------------C---------C---------C-C---------------C--PPB-----------------------
------------------S----BPP---------------S--------BPB-----------------B------------------P--------EE-----------------
-----------ES----EXXXX-------S--------XXXXS----EE-----E----------ES----------------------------E-SXXXX---------------
------S---XXXXXXXXXXXX----XXXXS----ES-XXXXXXXXXXXX----XXXX----XXXXXXXX-------SE----EE-----E---XXXXXXXXXXXX-----------
XXXXXXXXXXXXXXXXXXXXXX----XXXXXXXXXXXXXXXXXXXXXXXX----XXXX----XXXXXXXX----XXXXXXXXXXXX----XXXXXXXXXXXXXXXX-----------
