--------------------------------------------------------------------------------------------------------------------
--------------------------------------------------------------------------------------------------------------------
-----------------------X--------------------------------------------------------------------------------------------
----------------------XX--------------------------------------------------------------------------------------------
-----------------------X--------------------------------------------------------------------------------------------
------------------BBBPXXXXX--------------------------------------------------------------BBBBB----------------------
--------------------------------------------------------------------------------------------------------------------
----------------------------------------------------------------------------------------C---------------------------
--------------------------------------------------------------------------------------------------------------------
----------------P-------------------------------------------------------------------P--PB----B----------------------
--------------------------------XX----------------------------------------------------------------------------------
-----------------------------SX-XX------SX--------------------------------------------------------------------------
-----------------------------EX-XX------EX------------------------------------------C--------------C----------------
XXXXXXXXXXXXXXXXXX---XX----XXXXXXXXXXXXXXXXXXXXXXXXXXXXXXXXXXXXXXXXXXXXXXXXXXXXXXXXXXXXXXXXXXXXXXXXXXXXXXXXXXXXXXXXX
