---------------------------------------------------------------------------------------------------------------------
---------------------------------------------------------------------------------------------------------------------
---------------------------------------------------------------------------------------------------------------------
---------------------------------------------------------------------------------------------------------------------
---------------------------------------------------------------------------------------------------------------------
--------------------------------CC-------------------------------------C-C-------------------------------------------
--------C---C---------------C--C--------------------CC-----------C------C--------------------------------------------
------CC---C--------------C-------------------CCC-CC-------C---C-------------C-CC---C--C-----------------------------
------PBBB---C-C---C--C----BBPB-BBC---------CC---C-PB-C-------C-C--CC-B--PC-C------C-CC------------------------------
----------BPB---CCC--C--C------------C---C-------------C-C-----B-B---C-----C--C-----------C--CC--CC------------------
-----------------------C----------B-PBC-C---------------C---------C--------------------------------------------------
------E----------------------SS-------P--------------S------------PBPB-SE-----------------B-BPP----------------------
XXXXXXXXXX-EE-------------XXXXXXXX----------------XXXX-----------S----XXXX---------------S---------------------------
XXXXXXXXXXXXXX----S-------XXXXXXXX-EE----------SS-XXXX-----SS-XXXX----XXXX---SE----EE-XXXX---------------------------
XXXXXXXXXXXXXX----XXXX----XXXXXXXXXXXX--------XXXXXXXX----XXXXXXXX----XXXXXXXXXXXXXXXXXXXX--------XXXXXXXX-----------
