--------------------------------------------------------------------------------------------------------------------
--------------------------------------------------------------------------------------------------------------------
--------------------------------------------------------------------------------------------------------------------
--------------------------------------------------------------------------------------------------------------------
--------------------------------------------------------------------------------------------------------------------
--------------------------------------------------------------------------------------------------------------------
--------------------------------------------------------------------------------------------------------------------
--------------------------------------------------------------------------------------------------------------------
--------------------------------------------------------------------------------------------------------------------
-----------------P----------------XXXX-------------------------------------------------B-------XXX------------------
---------------------------------XXX-X---X-----------------------------------------------------XXX------------------
------------------------------SXXXXX-XXXXX------------------------------------------------SXX--XXX------------------
------------------------------XXXXX--XXXX-------------------------------------------------EEX-XXXX--B---------------
XXXXXXXXXXXXXXXXXXXXXX--XXX---XXXXXX-XXXXXXXXXXXXXXXXXXXXXXXXXXXXXXXXXXXXXXXXXXXXXXXXXXXXXXXXXXXXXXXXXXXXXXXXXXXXXXX
