--------------------------------------------------------------------------------------------------------------------
--------------------------------------------------------------------------------------------------------------------
--------------------------------------------------------------------------------------------------------------------
--------------------------------------------------------------------------------------------------------------------
--------------------------------------------------------------------------------------------------------------------
---------------------PBB-B-----BBB------------------------------------------BBBP------------------------------------
--------------------------------------------------------------------------------------------------------------------
--------------------------------------------------------------------------------------------------------------------
--------------------------------------------------------------------------------------------------------------------
--------------------B-----------------XXX---------------------------------PB----------------X--X--------------------
-----------------------------------X--XXX-------------------------------------------------XX--XX--------------------
------------------------------E---XXXXXXX-------------------------------------------------XX---XXX-X----------------
------------------------------E---XXXXXXX--------------------------------------C-C-------XXXXXXXXXX-X---------------
XXXXXXXXXXXXXXXXXXXXXXXXXXXXXXXXXXXXXXXXXXXXXXXXXXXXXXXXXXXXXXXXXXXXXXXXXXXXXXXXXX--XXXXXXXXXXXXXXXXXXXXXXXXXXXXXXXX
