-----------------------------------------------------------------------------------------------------
-----------------------------------------------------------------------------------------------------
-----------------------------------------------------------------------------------------------------
-----------------------------------------------E--E---E---E-E----------------------------------------
----------------------------------------------XXXXXXXXXXXXXXXX---------------------------------------
-------------------------------------------------------------------------------X---------------------
------------------------------------------------------------------------------XX---------------------
------E----------------------------------------------------------------------XXX---------------------
-----XX------------BB-----------------------XX----------------------E-------XXXX--BBB----------------
---E-XX------------------------------------------------------------XX------XXXXX---------------------
-XXX-XX------------------------------------------------------------XX-----XXXXXX---------------------
XXXX-XX------------------------------------------------------------XX-XX-XXXXXXX---------------------
XXXX-XX--------E---BBBB---------------------C-------------------E--XX-XXXXXXXXXX----------E-----E----
--XX-XXXXXXXXXXXX-----XXXXXXXXXXXXXXXXXXXXXXX-----------------XXXXXXXXXXXXXXXXXXXXXXXXXXXXXXXXXXXXXXX
