--------------------------------------------------------------------------------------------------------------------
--------------------------------------------------------------------------------------------------------------------
--------------------------------------------------------------------------------------------------------------------
--------------------------------------------------------------------------------------------------------------------
--------------------------------------------------------------------------------------------------------------------
---------------BBB--BBB----------------------------------------------------------------------------B----------------
--------------------------------------------------------------------------------------------------------------------
--------------------------------------------------------------------------------------------------------------------
--------------------------------------------------------------------------------------------------------------------
----------------------------------B------------------------------------------BBB-------SXX---B----------------------
---------------------------------------------------------------------------------------EEX--------------------------
-----------------------------SXX-X-----------------------------------------------------EEX--------------------------
-----------------------------EEXX-----------------------------------------X----------C-EEX--------CC----------------
XXXXXXXXXXXXXXXXXXXXX----X---XXXXXXXXXXXXXXXXXXXXXXXXXXXXXXXXXXXXXXXXXXXXXXXXXXXXXXXXXXXXXXXXXXXXXXXXXXXXXXXXXXXXXXX
