--------------------------------------------------------------------------------------------------------------------
--------------------------------------------------------------------------------------------------------------------
--------------------------------------------------------------------------------------------------------------------
--------------------------------------------------------------------------------------------------------------------
--------------------------------------------------------------------------------------------------------------------
---------------B-----BB------------------------------------------------------B-----------BBBB-BBB-------------------
--------------------------------------------------------------------------------------------------------------------
--------------------------------------------------------------------------------------------------------------------
--------------------------------------------------------------------------------------------------------------------
-----------------------------------XXX--XXX-----------------------------------P--PB-----B---------------------------
----------------------------------XXXX--XXX-------------------------------------------------------------------------
------------------------------SXXXXXXX--XXX------------------------------XSX----------------------------------------
------------------------------EXXXXXXX--XXX------------------------------EEX--------------------CCC-----------------
XXXXXXXXXXXXXXXXXXXXX---XX----XXXXXXXXXXXXXXXXXXXXXXXXXXXXXXXXXXXXXXXXXXXXXXXXXXXXXXXXXXXXXXXXXXXXXXXXXXXXXXXXXXXXXX
