---------------------------------------------------------------------------------------------------------------------
---------------------------------------------------------------------------------------------------------------------
---------------------------------------------------------------------------------------------------------------------
---------------------------------------------------------------------------------------------------------------------
---------------------------------------------------------------------------------------------------------------------
------------------C--C-C----------------CC-----CC--C--------------C------C-------------------------------------------
------------C------C------------------C-------C-----C----C---C-----C--C-C--CC-----CCC-CCCCCC--C---C------------------
-------C---------C--C---------------------CC-----------C--C-----C---------------C----C-------C-----------------------
------C-CC---C----------B------CC-C-C-------C-BBB-BP----C---C-CC-C------PP----C--C-B-BP-B---C---C--------------------
--------BB-----C----------CC---------C----------------B-------------------BBP--C----------BB-B-----------------------
--------------------------BBBB---------------------------------------------------------------------------------------
------------------E----EE------B-B-------E-----EE----S------------E----SE----------SE----E--------EE-----------------
------E----SS-----XXXXXXXX------------XXXX----XXXXXXXXE----ES-----XXXXXXXX---E----XXXXXXXXE----ESEXXXX---------------
XXXXXXXXXXXXXX---SXXXXXXXX---E-----SE-XXXXE---XXXXXXXXXXXXXXXX---EXXXXXXXXXXXXE---XXXXXXXXXXXXXXXXXXXX---------------
XXXXXXXXXXXXXXXXXXXXXXXXXXXXXX----XXXXXXXXXXXXXXXXXXXXXXXXXXXXXXXXXXXXXXXXXXXXXXXXXXXXXXXXXXXXXXXXXXXX---------------
