---------------------------------------------------------------------------------------------------------------------
---------------------------------------------------------------------------------------------------------------------
---------------------------------------------------------------------------------------------------------------------
---------------------------------------------------------------------------------------------------------------------
---------------------------------------------------------------------------------------------------------------------
----------C--C-C-----------------------------------------------CC----------C-C---------------------------------------
------------C------------------C-C-CC---C--CC----------------------------CC------------C-----------------------------
------C----C--C-C-----------C--------C-C--C--------------CCCCC------------------C-----C--C----C----------------------
-------BBBBB-------------C------C-C---C--C-----C--C-C-CC--------BP------------C--C------C--CCC--CC-------------------
--------------------C-----CC--P-B------------P--------------------C---------------C-CCPBBBC----C--C------------------
-------------------C------BBB---------------------------------------C---------------------P-P------------------------
------S----SE----E------B---------------------BBB-P--------------S-BBB-------E-----P-B-------------------------------
XXXXXXXXXXXXXXXXXX------------S----EE----EE-----------S----EE-XXXX-----ES-XXXXS----------S---------------------------
XXXXXXXXXXXXXXXXXX-----------SXXXXXXXXXXXXXXXX--------XXXXXXXXXXXX----XXXXXXXXXXXX----XXXXE----EESES-----------------
XXXXXXXXXXXXXXXXXX--------XXXXXXXXXXXXXXXXXXXX--------XXXXXXXXXXXX----XXXXXXXXXXXX----XXXXXXXXXXXXXXXXXXXX-----------
