--------------------------------------------------------------------------------------------------------------------
--------------------------------------------------------------------------------------------------------------------
--------------------------------------------------------------------------------------------------------------------
--------------------------------------------------------------------------------------------------------------------
--------------------------------------------------------------------------------------------------------------------
---------------------------------------BBBB-------------------------------------------------------------------------
--------------------------------------------------------------------------------------------------------------------
--------------------------------------------------------------------------------------------------------------------
--------------------------------------------------------------------------------------------------------------------
-------------------BBB-P--P---------B--------------------------------------------------------XXX--XXX---------------
--------------------------------------------------------------------------------------------XXXX--XXX---------------
------------------------------SXX--------------------------------------------------------XXXXXXX-XXXX---------------
----------------C-C-C---------EEX--------C-----------------------------------------------XXXXXXX-XXXX---------------
XXXXXXXXXXXXXXXXXXXXXXXXXXXXXXXXXXXXXXXXXXXXXXXXXXXXXXXXXXXXXXXXXXXXXXXXXXXXX--XXX---XXXXXXXXXXXXXXXXXXXXXXXXXXXXXXX
