--------------------------------------------------------------------------------------------------------------------
--------------------------------------------------------------------------------------------------------------------
--------------------------------------------------------------------------------XX----------------------------------
--------------------------------------------------------------------------------XX----------------------------------
--------------------------------------------------------------------------------XX----------------------------------
------------------BBBPB--------------------------------------------------BBB--XXXXXXX----------BBB------------------
--------------------------------------------------------------------------------------------------------------------
--------------------------------------------------------------------------------------------------------------------
--------------------------------------------------------------------------------------------------------------------
--------------------B--P---------------XX---------------------------------------------------------------------------
----------------------------------XX--XXX----------------------------------------------------------X----------------
-------------------------------SX-XXXXXXX----------------------------------------------------------XX---------------
----------------C---C---------EEXXXXXXXXXX--------------------------------------------------------XXX---------------
XXXXXXXXXXXXXXXXXXXXXXXXXXXXXXXXXXXXXXXXXXXXXXXXXXXXXXXXXXXXXXXXXXXXXXXXXXXXXXXX---XXXXXXXXXXXXXXXXXXXXXXXXXXXXXXXXX
