--------------------------------------------------------------------------------------------------------------------
--------------------------------------------------------------------------------------------------------------------
--------------------------------------------------------------------------------------------------------------------
--------------------------------------------------------------------------------------------------------------------
--------------------------------------------------------------------------------------------------------------------
----------------------------------------------------------------------------BBB-------------------------------------
--------------------------------------------------------------------------------------------------------------------
--------------------------------------------------------------------------------------------------------------------
--------------------------------------------------------------------------------------------------------------------
--------------------------------SXX--B-------------------------------------B--P---B--P-----------X------------------
--------------------------------EEX--------------------------------------------------------------X------------------
--------------------------------EEX-------------------------------------------------------SX-----XX-----------------
------------------------------C-EEXC------C----------------------------------------C-C----EX-XX-XXX-----------------
XXXXXXXXXXXXXXXXX-----X-------X-XEX----XXXXXXXXXXXXXXXXXXXXXXXXXXXXXXXXXXXXXXXXXXXXXXXXXXXXXXXXXXXXXXXXXXXXXXXXXXXXX
