--------------------------------------------------------------------------------------------------------------------
--------------------------------------------------------------------------------------------------------------------
-----------------------X--------------------------------------------------------XX----------------------------------
----------------------XXX------------------------------------------------------XXXX---------------------------------
----------------------XXX-------------------------------------------------------XXX---------------------------------
---------------------XXXXXX----BBBB---------------------------------------------XXXXXX------------------------------
--------------------------------------------------------------------------------------------------------------------
--------------------------------------------------------------------------------------------------------------------
--------------------------------------------------------------------------------------------------------------------
--------------------------------SXX---------------------------------------P---------------SX------------------------
--------------------------------EEX-------------------------------------------------------XX------------------------
--------------------------------EEX------X------------------------------------------------E-------------------------
--------------------------------EEXC----XXX---------------------------------------------C-E-------------------------
XXXXXXXXXXXXXXX------------XXXXXXXXXXXXXXXXXXXXXXXXXXXXXXXXXXXXXXXXXXXXXX------------------------XXXXXXXXXXXXXXXXXXX
