--------------------------------------------------------------------------------------------------------------------
--------------------------------------------------------------------------------------------------------------------
--------------------------------------------------------------------------------------------------------------------
--------------------------------------------------------------------------------------------------------------------
--------------------------------------------------------------------------------------------------------------------
-------------------------------BBBBBBP------------------------------------BB--BB------------------------------------
--------------------------------------------------------------------------------------------------------------------
------------------------------C-------------------------------------------------------------------------------------
--------------------------------------------------------------------------------------------------------------------
--------------------------P--PB----BB-----B----------------------------------B-B------------B-----------------------
-------------------------------------------------------------------------------------------------XX-----------------
----------------------------------------------------------------------------------------E-------XXX-----------------
-----------------------------------------C----------------------------------------------E--C----XXX-----------------
XXXXXXXXXXXXXXXXXXXXXXXXXXXXXXXXXXXXXXXXXXXXXXXXXXXXXXXXXXXXXXXXXXXXXXXXXXXXXXXXXXXXXXXXXXXXXXXXXXXXXXXXXXXXXXXXXXXX
