---------------------------------------------------------------------------------------------------------------------
---------------------------------------------------------------------------------------------------------------------
---------------------------------------------------------------------------------------------------------------------
---------------------------------------------------------------------------------------------------------------------
---------------------------------------------------------------------------------------------------------------------
------C-CC---------------------------------C----------------CC-------------------------------------------------------
-----------C-C----------------------------C-----C----------C--------C--------------------C---------------------------
-------C----C----C--------C-C-C-C-C---------C-C-----------C-----------------------C-C--------------------------------
--------------C-------CC-C-----C----CC---C---B---C-CC---C----------C----C-C-----------CCC--C-------C-----------------
-----------BB---C---C------------C------------BPPPC--C--------C--C---------C--C-------BBBB--C-C----------------------
---------------------------B-BBBBBPPBP----------------BBB------CC--------CB------------------C--C-C------------------
------S-----------------------------------E--------BBB-----EE---------BBBB----------------PBB------------------------
XXXXXXXXXX-SE----------SE----------------SXXXX-SE---------XXXX----E----------------SE---E----------------------------
XXXXXXXXXXXXXX---EE---XXXX---SS----SE-XXXXXXXXXXXX----E---XXXX----XXXX-------E----XXXXXXXX---------------------------
XXXXXXXXXXXXXXXXXXXXXXXXXXXXXXXXXXXXXXXXXXXXXXXXXX----XXXXXXXX----XXXX----XXXX----XXXXXXXX------------XXXX-----------
