---------------------------------------------------------------------------------------------------------------------
---------------------------------------------------------------------------------------------------------------------
---------------------------------------------------------------------------------------------------------------------
---------------------------------------------------------------------------------------------------------------------
---------------------------------------------------------------------------------------------------------------------
---------------------------C----------C--C------------------------C--C-----------------------------------------------
------------------CC-C-----------------CC-----C-C-----------------------CC------------------------C------------------
--------C------CCC--C--CC-C--C---------------C-C----------C--C---------C---C-----------------------------------------
------C------CC-----------PBPB-------------C------C-C----------------PC-----CCCCC-CC--C----C-CC-C--B-----------------
-------C----C---------BBPB----BBBP-C----------BB-B-------------C-C----BP--C------C-----C--C-C------------------------
-----------C-----------------------B---------B-----C-CCC--------------------------------C-BBB------------------------
----------B------------------E-----------S--------B---------------E-------------------B--P----B----------------------
------------------E----EE-XXXXS-------XXXX-----SS-----------------XXXX-SS-------------------------XXXX---------------
------E----------EXXXXXXXXXXXXXXXX-SE-XXXXE---XXXX---------ES-----XXXXXXXX---E-----ES-----E-------XXXX---------------
XXXXXXXXXX----XXXXXXXXXXXXXXXXXXXXXXXXXXXXXXXXXXXX--------XXXX----XXXXXXXXXXXX----XXXX----XXXX----XXXXXXXX-----------
