-----------------------------------------------------------------------------------------------------
-----------------------------------------------------------------------------------------------------
-------------------------------BBBBBBBBBBBBBBBBBBBBBBBBBBBBBBBBBBBBBBBBBBBBBBBBBBBBBBBBBBBBB---------
-----------------------------------------------------------------------------------------------------
-----------------------------------------------------------------------------------------------------
--------------B---------------B-------B-----------------------------BB-------------------------------
-----------------------------------------------------------------------------------------------------
-----------------------------------------------------------------------------------------------------
----E-----------------------------------------------------------------------------E------------------
X--XX---------P---------------B-------B-----------BBBBBBBB----------BB------E----XX---BBBBBB---------
X--XX-------------------------------------B-----------------------E--------XX----XX------------------
X--XX-------------------------------------B----------------------XX--------XX----XX------------------
X--XX-----------------------EE------E-----B--------------EEE-----XX--------XX-E--XX------------------
XX-XXXXXXXXXXXXXXXXXXXXXXXXXXXXXXXXXXXXXX-X---XXXXXXXXXXXXXXXXXXXXXXXXXXXXXXXXXXXXX--XXXXXXX--XXXXX--
