--------------------------------------------------------------------------------------------------------------------
--------------------------------------------------------------------------------------------------------------------
--------------------------------------------------------------------------------------------------------------------
--------------------------------------------------------------------------------------------------------------------
--------------------------------------------------------------------------------------------------------------------
-------------------------------BBB---BB-----------------------------------------------------------------------------
--------------------------------------------------------------------------------------------------------------------
--------------------------------------------------------------------------------------------------------------------
--------------------------------------------------------------------------------------------------------------------
------------------------------------XXXX-------------------------------------------------------XXX------------------
-----------------------------------XXXX---X-----------------------------------------------X----XX-------------------
---------------------------------XXXXXXX-XX----------------------------------------------EXXX-XXXX------------------
---------------------------------XXXXXXXXXX----------------------------------------------E-XXXXXXXX-X---------------
XXXXXXXXXXXXXXXXXXX--XXX---X----XXXXXXXXXXXXXXXXXXXXXXXXXXXXXXXXXXXXXXXXXXXXXXXXXXXXXXXXXXXXXXXXXXXXXXXXXXXXXXXXXXXX
