--------------------------------------------------------------------------------------------------------------------
--------------------------------------------------------------------------------------------------------------------
--------------------------------------------------------------------------------------------------------------------
--------------------------------------------------------------------------------------------------------------------
--------------------------------------------------------------------------------------------------------------------
-------------------------------------------------------------------------B------------------------------------------
--------------------------------------------------------------------------------------------------------------------
--------------------------------------------------------------------------------------------------------------------
--------------------------------------------------------------------------------------------------------------------
--------------------P-----------SX---BBP----------------------------------------------------B-B---------------------
--------------------------------EX----------------------------------------------------------------------------------
-------------------------------EEX-----------------------------------------------------SXX--------------------------
------------------------CC-C----EX-----C-----------------------------------------------EEX--------------------------
XXXXXXXXXXXXXXXXXXXXXXXXXXXXXXXXXXXXXXXXXXXXXXXXXXXXXXXXXXXXXXXXXXXXXXXXX---XXX----X---XXXXXXX-XXXXXXXXXXXXXXXXXXXXX
