---------------------------------------------------------------------------------------------------------------------
---------------------------------------------------------------------------------------------------------------------
---------------------------------------------------------------------------------------------------------------------
---------------------------------------------------------------------------------------------------------------------
---------------------------------------------------------------------------------------------------------------------
---------------------------C-----------C--------------------------C--------------------------------------------------
---------C---------CCC-C-CC--C--------C--------------------CC--------C-----------------C-------C--C------------------
--------------C-------C-----C-----C-CC---C-C--C-------CC-C-------C-CC-----------C---------------CC-------------------
-------CC-------C-------C-BBBPC-----------C---------C-----C----C-----P-----------CC-C-B-BPC--C-----C-----------------
--------BB--CC-C----------------C------------C-BP--C------------C---------C--------C---------------------------------
----------CC------------------PBB-----------BP-------CB----------------CC--CCC-------------C-------------------------
----------P-B----------------E-----------E--------BBBB------------S----PB-BB-------B-B---S-----S---------------------
------S-----------E----E-SXXXX--------XXXX-----ES----------ES-----XXXX--------S-------XXXX----XXXXEE-----------------
XXXXXXXXXX-------EXXXXXXXXXXXXE----EE-XXXXS---XXXX----E---XXXX--E-XXXX--------XXXX----XXXX----XXXXXXXX---------------
XXXXXXXXXX----XXXXXXXXXXXXXXXXXXXXXXXXXXXXXXXXXXXX----XXXXXXXXXXXXXXXX--------XXXX----XXXX----XXXXXXXX---------------
