-----------------------------------------------------------------------------------------------------
-----------------------------------------------------------------------------------------------------
--------------------------------------CCC------------------------------------------------------------
-----------------------------------------------------------------------------------------------------
-----------ECCCCCCCCC----------CC--------------------------------------------------------------------
--BB-------XXXXXXXXXXX------------X------------------------------------------------------------------
-----------------------------------------------------------------------------------------------------
-----------------------------------------------------------------------------------------------------
-----------------------------------XXXXXXXXX---------BB-----------------------------------X----------
-XXXXXXXXXXXXXXXXXXXXXXXXX----X------------------EB--------------------------------------XX----------
XXX----------------------------------------------------------------------------------E--XXX--E-------
X---------------------------E---XX-----------------------------------------------------XXXX-XX-------
------------------------------------------------------------------E-----------EE---E--XXXXX-XX-------
---XX-----------------------X---------------XXXXXXXXXXXXXXXXXXXXXXXXXXXXXXXXXXXXXXXXXXXXXXXXXXXXXXXXX
