---------------------------------------------------------------------------------------------------------------------
---------------------------------------------------------------------------------------------------------------------
---------------------------------------------------------------------------------------------------------------------
---------------------------------------------------------------------------------------------------------------------
---------------------------------------------------------------------------------------------------------------------
------------------------------CC----------------------C-----------C-----------------------CC-------------------------
------------------C-------C--C---C------------C------------C-------C--CC---C-C--CC--------------C--------------------
------C----CCC-------------C---------------------C------C-C---C---------CCC-C------C--------C-CC-C-C-----------------
-------C--B-BB-C---CCC-CC-----B--BCCC--------C-C---CC-------CC--C-PBB---------C-----C-----BP-B----C------------------
--------C-------------C--C-BBB----------C-----B-B----------------------BPPB------------BBB----P----------------------
--------B-----C-CC--------------------C----CC------------------------------------------------------------------------
-----------ES-BB--------------S---B---------------P---E-----------E-----------------------E--------------------------
----------XXXX----E----------EXXXX-------------EE-----XXXX-EE-----XXXX-EE---E-S----EE----EXXXX-S-SES--XXXX-----------
------E---XXXX----XXXX----XXXXXXXX------------XXXX----XXXXXXXX---EXXXXXXXXXXXXXXXXXXXXXXXXXXXXXXXXXXXXXXXX-----------
XXXXXXXXXXXXXX----XXXX----XXXXXXXX------------XXXX----XXXXXXXXXXXXXXXXXXXXXXXXXXXXXXXXXXXXXXXXXXXXXXXXXXXX-----------
