-----------------------------------------------------------------------------------------------------
-----------------------------------------------------------------------------------------------------
-----------------------------------------------------------------------------------------------------
-----------------------------------------------------------------------------------------------------
---------------------------------------EC------------------------------------------------------------
----------------------------------P----XXX---XXX-----------------------------------------------------
---------------------------------------------XXX----------------------------------C------------------
---------------------------------------------XXX---B-------------------------------------------------
--------------E------------------------------XXX---b-------------------------------------------------
-------------XX-----------------B-----XXXXXX-XXX--BXB--E-----X---BBB---------------------------------
-------------XX------------------------------XXX------XX-----X--------------E-------------E---------X
B-------X----XX------------------------------XXX------XX-----X-------------XX------------XX--------XX
---X---XX----XX------------------------------XXX------XX-----X-------------XX-------E----XX----------
-XXXXXXXXXXXXXXXXXXXXXXXXXXXXXXXXXXXXX-------XXXXXXXXXXXX----X--XXXXXXXXXXXXXXXXXXXXXXXXXXXXXXXXXXXXX
