-----------------------------------------------------------------------------------------------------
-----------------------------------------------------------------------------------------------------
-----------------------------------------------------------------------------------------------------
X----------------------------------------------------------------------------------------------------
-----------------------------------------------------------------------------------------------------
-------------------------------------------BB----------BBB-XX----------------------------------------
--------------------------------------------------------------------C--------------------------------
------------------------------------C----------------------------------------------------------------
----CCCC-----------------------------------BB--------------------------------------------------E-----
------------------------------B-BBBB----------------X-XXXXX----------------BBB----------------XX-----
---------------------------------------------------XXXXX--------E---------------------------E-XX--E--
--------------------------------E-----------------XXXX---------------------E------------------XX-XX--
------------X---------EE----E--------------------XXXX-----------------EE-------------E----E---XX-XX--
------XXXXXXXXXXXXXXXXXXX-XXXXXXXXXXXXXXX----XXXXXXXX---X-----XXXXX-XXXXXXXXXXXXXXXXXXXXXXXXXXXXXXXXX
