---------------------------------------------------------------------------------------------------------------------
---------------------------------------------------------------------------------------------------------------------
---------------------------------------------------------------------------------------------------------------------
---------------------------------------------------------------------------------------------------------------------
---------------------------------------------------------------------------------------------------------------------
--------C------------------------------------------CCC-----------------------------------------CC--------------------
-------C-C-----------------C--------------C----C----------------C---------C------------------------------------------
-------------------------CC--C----------------C-CC-------------C-------C---------CCCC----C--------C------------------
--------BPCC---C---------------C--C-C--C-----CBBB-BBBB--------C----C-------C--------------C--------------------------
------------------C-C--C-----------C--C--C------------------------------CC----------PB-C----CC-----------------------
------------CC---C--------------CC---C----------------CCCCC--C-------C----------------PBPP---------------------------
------E----BBB---------------SB-BPPP-B---------ES----EBBBB--------------------S-----------BB---E-E-------------------
XXXXXXXXXX----------------XXXX------------S---XXXXXXXX-----------S-----------EXXXX-EE---------XXXX-E-----------------
XXXXXXXXXX--------S----EE-XXXX------------XXXXXXXXXXXX--------XXXX-----EE-XXXXXXXXXXXX---S----XXXXXXXX---------------
XXXXXXXXXX--------XXXXXXXXXXXX------------XXXXXXXXXXXX--------XXXX----XXXXXXXXXXXXXXXXXXXX----XXXXXXXX---------------
