---------------------------------------------------------------------------------------------------------------------
---------------------------------------------------------------------------------------------------------------------
---------------------------------------------------------------------------------------------------------------------
---------------------------------------------------------------------------------------------------------------------
---------------------------------------------------------------------------------------------------------------------
--------------------------C----------------------------CC------CCC--C------------------CC----------------------------
------------------C---------CC---C-C-C---------CC---------C--C----C--------C--CCC-----C--C---------------------------
----------C----------C--------------C------C------------------C------CC-C-C-C-----C-CC-----C--C----------------------
-------CCCB-----------CCC-B--P--C-C---C-C---C-BBBB----------C-------BB---C---C---C-------P-----C-C-------------------
----------------C--------C----B--------C-----C------C------------------B-BBP-------C------BBBB-----------------------
--------------CC-C----BBBB------------------B------------------------------------------------------------------------
--------PB-SE-----E----------E-----------------EE-B-B-E----------SS---------------------E----------------------------
XXXXXX----XXXX----XXXX----XXXXS----SS---------XXXX----XXXX-SS-XXXXXXXX-EE----SS-------XXXXE----EEE-------------------
XXXXXX----XXXX----XXXX-ES-XXXXXXXXXXXX----S---XXXX----XXXXXXXXXXXXXXXXXXXXXXXXXXXX-EE-XXXXXXXXXXXX-------------------
XXXXXX----XXXX----XXXXXXXXXXXXXXXXXXXX----XXXXXXXX----XXXXXXXXXXXXXXXXXXXXXXXXXXXXXXXXXXXXXXXXXXXX----XXXX-----------
