--------------------------------------------------------------------------------------------------------------------
--------------------------------------------------------------------------------------------------------------------
--------------------------------------------------------------------------------------------------------------------
--------------------------------------------------------------------------------------------------------------------
--------------------------------------------------------------------------------------------------------------------
-----------------BBBBPB-P------------BB-----------------------------------BBBBBBBBPB--------------------------------
--------------------------------------------------------------------------------------------------------------------
--------------------------------------------------------------------------------------------------------------------
--------------------------------------------------------------------------------------------------------------------
-----------------B-BB--P--------------------------------------------------------------------XXX---------------------
-------------------------------SX-----------------------------------------------------------XX----XX----------------
-------------------------------E------XX------------------------------------------------SXXXXX----XX----------------
----------------C--------------E------XXX-----------------------------------------------E-XXXX---XX-----------------
XXXXXXXXXXXXXXXXXXXXXXXXXXXXXXXXXXXXXXXXXXXXXXXXXXXXXXXXXXXXXXXXXXXXXXXXXXXXXXXXXXXXXXXXXXXXXXXXXXXXXXXXXXXXXXXXXXXX
