--------------------------------------------------------------------------------------------------------------------
--------------------------------------------------------------------------------------------------------------------
--------------------------------------------------------------------------------------------------------------------
--------------------------------------------------------------------------------XX----------------------------------
---------------------------------------------------------------------------------X----------------------------------
-----------------------------------------------------------------------------BBBXBXBX-------------------------------
--------------------------------------------------------------------------------------------------------------------
--------------------------------------------------------------------------------------------------------------------
--------------------------------------------------------------------------------------------------------------------
-----------------------------B-------BB-------------------------------------------B-----------BB--------------------
--------------------------------E-----------------------------------------------------------------------------------
--------------------------------SXX---------------------------------------------------------------SXX---------------
------------------------C-C-----EEX--------------------------------------------------C------------E-C---------------
XXXXXXXXXXXXXXXXXXXXXXXXXXXXXXXXXXXXXXXXXXXXXXXXXXXXXXXXXXXXXXXXXXXXXXXXXXXXX--XXXXXXXXXXXXXXXXXXXXXXXXXXXXXXXXXXXXX
