-----------------------------------------------------------------------------------------------------
-----------------------------------------------------------------------------------------------------
BBBBBBBBBBBBBBBBBBBBBBBBBBBBBBBBBBBBBBBBBBBBBBBB-----------------------------------------------------
-------------------------B--------BB-----------------------------------------------------------------
-P--------------------E--B-----E--BB-----------------------------------------------------------------
BPP------E------------BBB------BBB-------------------------------------------------E-----------------
--------XX------------BBB------BBB------------------------------------------------XX------------CCCC-
--------XX------------BBB------BBB------------------------------------------------XX-----------------
--------XX--------E---BBB------BBB---------------CC-------------------------------XX-----------------
BBBBBBBBXX--E----XX---BBBB-----BBBBB--BBB---E--B--------------------E--------E---BXXX----XX----------
--------XX-XX----XX------B--------BB-------XX----------------------XX------EXX-----------XX----------
--------XX-XX----XX------B--------BB-------XX----------------------XX-----XXXX-----------XX----------
--------XX-XX----XX-----E--------E---E-----XX------------X---------XX-----XXXX-E---------XX----------
XXXXXXXXXXXXXXXXXXX--XXXXXXXXXXXXXXXXXXXXXXXXXXX--XXXXXXXXXXXX-XXXXXXXXXXXXXXXXXXXXXXXX--XXXXXXXXXXXX
