-----------------------------------------------------------------------------------------------------
-----------------------------------------------------------------------------------------------------
BBBBBBBBBBBBBBBBBBBBBBBBB----------------------------------------------------------------------------
-----------------------------------------------------------------------------------------------------
-----------------------------------------------------------------------------------------------------
-----------------------E-------------------------------CC--------------------------------------------
----------------------XX-------------------XX---X---XXXX-----BB--------------------------------------
----------------------XX-----------------------------------------------------------------------------
--------E-------------XX-----------------------------------------------------------------------------
-------XX-----E-------XXB---------E---XXX----------------XXX-------------------------------B---B-----
-------XX----XX-------XX---------XX----------------------------X------------------------E------------
-------XX----XX-----X-XX---------XX-E-------XXXXXXXXX---------XX--------X--------------XX------------
E------XX----XX----XX-XX---------XX--------------------------XXX-------XX-------E-EE---XX------E-----
XXXXXX-XX-XXXXXXXXXXXXXXX--------XXXX------------------------XXXX-XXXXXXXXXXXXXXXXXXX-XXXXXXXXXXXXXX-
