-----------------------------------------------------------------------------------------------------
-----------------------------------------------------------------------------------------------------
-----------------------------------------------------------------------------------------------------
-----------------------------------------------------------------------------------------------------
-----------------------------------------------------------------------------------------------------
---------------------------------------------------------------------P--------BBBBBBB----------------
-----------------------------------------------------------CC----------------------------------------
-------------------------------------C---------------------------------------------------------------
---E--------------------------------------------CCC--------------------------------------------------
E-XX----------------------------E-EBB--------------------------------B----------------------BBBB-----
X------------------------------XX------------------------E-------------------------------------------
X----------------------------------------------------------------------------------------------------
X---------X-----------------E-------------E-----------------------X-----E------EE--------------------
XXXXXXXXXXXXXXXXXXXXXXX-XXXXXXXXXXXXXXXXXXXXXXXXXXXXXXXXXXXXXXXXXXXXXXXXXXXXXXXXXXXXXXXXXXXXXXXXXXXXX
