-----------------------------------------------------------------------------------------------------
-----------------------------------------------------------------------------------------------------
BBBBBBBBBBB------------------------------------------------------------------------------------------
B--------------------------E-------------------------------------------------------------------------
B-------------------------XXX----------CCC-------------CC--------------------------------------------
--------------------E----------------XXXXXX----------------------------------------------------------
-------------------XX------------CC---------C--------------------------------------------------------
-------------------XX----------------------XXXX---------------------------------------------X--------
PP-----------------XXX------------------------------------------------------------------CCC----------
B---------------------------------XXX----------------------------------------------------------------
------BBBBB--------------------------------C---------------------------------------------------------
------BBBBB-------------------------------XXXXXXXXX--------------------------E-----------------------
------BBBBB---------------------XX---------------------EE-E---------------E----------------------EEE-
XXXXX-XXXXXXXXXXXXXXXXXX-----XX----------------------XXXXXXXXXXXXXXXXXXXXXXX-XXXXXXXX-XXX---XXXXXXXXX
