--------------------------------------------------------------------------------------------------------------------
--------------------------------------------------------------------------------------------------------------------
--------------------------------------------------------------------------------------------------------------------
--------------------------------------------------------------------------------XXX---------------------------------
--------------------------------------------------------------------------------XX------------------C---------------
--------------------------------------------------------------------------------XXX----------BBBBBBBB---------------
--------------------------------------------------------------------------------------------------------------------
----------------------------------------------------------------------------------------------C---------------------
--------------------------------------------------------------------------------------------------------------------
-------------------------------------XXX-----------------------------------------------BB---BBB----BB---------------
------------------------------------XXXXX-X-------------------------------------------------------------------------
--------------------------------E--XXXXXXXX-------------------------------------------------------------------------
----------------------------C---E-XXXXXXXXX--------------------------------------------------------C----------------
XXXXXXXXXXXXXXXXXXX--XXXX-XXXXXXXXXXXXXXXXXXXXXXXXXXXXXXXXXXXXXXXXXXXXXXXXXXXXXXX--XXXXXXXXXXXXXXXXXXXXXXXXXXXXXXXXX
