-----------------------------------------------------------------------------------------------------
-----------------------------------------------------------------------------------------------------
-----------------------------------------------------------------------------------------------------
-----------------------------------------------------------------------------------------------------
CC---------------------------------------------------------------------------------------------------
-----X--------------------------------------------------------------------XXXXX----------------------
-------XXXX---------------------------------------------------------------XXXXX----------------------
-------------------------------------------------------------------------XXXXXX----------------------
--------------------C----------------------E----------------------------XXXXXXX-------E----------E---
------------------------------------------XX---------------------------EXXXXXXX------XX---------XX--X
------------------E-----E-----------------XX--------------------------XXXXXXXXX------XX---------XX--X
-XXXX------------XX----XX-----------------XX-------------------------XXXXXXXXXX------XX---------XX--X
------------EEEE-XX----XX-----------------XX-------------E-----E----XXXXXXXXXXX-E----XX-----EE--XX--X
----------XXXXXXXXXXXXXXXX--XXXXXXXXXXXXXXXXXXXXXXXXXXXXXXXXXXXXXXXXXXXXXXXXXXXXXXXXXXXXXXXXXXXXXXXXX
