---------------------------------------------------------------------------------------------------------------------
---------------------------------------------------------------------------------------------------------------------
---------------------------------------------------------------------------------------------------------------------
---------------------------------------------------------------------------------------------------------------------
---------------------------------------------------------------------------------------------------------------------
------------------------------------------------C-C-C------C-C----------------------------------C--------------------
-----------------------C----------C-C--------------------------C-C-------C----C-CCC-CC-------------------------------
---------------------CC-CC------C-----C---CC-CC-------C---C-C-C-C-----C-C----------------------C-C-------------------
-----------C----CCC----------C-C---C-C-C------BP-P-B-B--C---------C----C---C----------C--------B---------------------
------CC--C----------------CC----CBP---------B---------------------BBPBB--C--C---------P-B---------------------------
------------------------------PPBB---------------------------------------------------------CC-----CC-----------------
---------B-------------ES-PPBB-----------------ES----E-----EE----E------------E------------B-B-EEE-------------------
------------------S---XXXX---------ES-----S---XXXXXXXX----XXXXXXXXE----ES-----XXXX-SE----S----XXXX-------------------
-----------EE----SXXXXXXXX----S---XXXX---EXXXXXXXXXXXXS---XXXXXXXXXXXXXXXX---SXXXXXXXXXXXX----XXXX-------------------
XXXXXX----XXXXXXXXXXXXXXXX----XXXXXXXXXXXXXXXXXXXXXXXXXXXXXXXXXXXXXXXXXXXXXXXXXXXXXXXXXXXX----XXXX----XXXX-----------
