-----------------------------------------------------------------------------------------------------
-----------------------------------------------------------------------------------------------------
-----------------------------------------------------------------------------------------------------
---------------------------------------XX------------------------------------------------------------
---------------------------------------XX----------------CC------------------------------------------
-----------BPB-------------------------XX--BBBB------B--------BBBB-----------------------------------
E--------------------------------------XX------------------------------------------------------------
X--------------------------------------XX------------------------------------------------------------
X--------------------------------------XX-B--------------------------------------------------XX------
X----------BBB------E------------------XX------------B-----------BBBBPBB--------------------XXX------
--E----------------XX--------B---------XX--------------------------------------------------XXXX------
-------------------XX--------b---B-----XX------------------------------------B-------------XXXX------
-------------------XX--E---------b-----XX------EEEEE-----EE------------------b------E------XXXX------
XXXXXXXXXXXXXXXXXXXXXXXXXXXXXXXXXXXXXXXXXXXXXXXXXXXXXXXXXXXXXXXXXXXXXXXXXXXXXXXXXXXXXXXXXXXXXX---XXXX
