---------------------------------------------------------------------------------------------------------------------
---------------------------------------------------------------------------------------------------------------------
---------------------------------------------------------------------------------------------------------------------
---------------------------------------------------------------------------------------------------------------------
---------------------------------------------------------------------------------------------------------------------
--------------C-C---------------------------------------------C-CC---------------------C-------C-C-------------------
------------------------------------------------------C-C-------------------------C-C-C--CC--------------------------
------C---C----C-C--------CC---C--CCC---------CCC-C-C--C------------CC------------------C----C-----------------------
--------C---------C---CC--------C------C---------------------C-BBB-C--------C---C-----BP-BBPP-----C------------------
-------C-C--------------C----CB-BB---CC-----CC-----C-------------------C-C-C-CC--C-----------------------------------
--------BBPP-----------------B----BB-------BB-BBBBPP------C-C------PBB-----------------------------------------------
-----------------E------------------------------------E------B---S-----P-----------SE----SS----E-E-------------------
--------------XXXX------------S-----------------------XXXX----XXXX----------------XXXXXXXXXXXXXXXXEE-----------------
------S----EE-XXXX-----SE----SXXXX-SE-----S----SS----EXXXX----XXXXE----------E----XXXXXXXXXXXXXXXXXXXX---------------
XXXXXXXXXXXXXXXXXX----XXXXXXXXXXXXXXXX----XXXXXXXXXXXXXXXX----XXXXXXXX----XXXX----XXXXXXXXXXXXXXXXXXXX---------------
