--------------------------------------------------------------------------------------------------------------------
--------------------------------------------------------------------------------------------------------------------
--------------------------------------------------------------------------------------------------------------------
----------------------X---------------------------------------------------------------------------------------------
----------------------X---------------------------------------------------------------------------------------------
---------------------BXBXBX-----------------------------------------------------------------------------------------
--------------------------------------------------------------------------------------------------------------------
--------------------------------------------------------------------------------------------------------------------
--------------------------------------------------------------------------------------------------------------------
--------------------------------SX-----X----------------------------------PP---------------------X------------------
-------------------------------SEX-----X--------------------------------------------------------XX------------------
-------------------------------EEX----XXX-------------------------------------------------SX---XXXX-----------------
-------------------------------EEX-CX-XXX----------------------------------------C--C-----E--XXXXXX-----------------
XXXXXXXXXXXXXXXXXXXXXXXX-XXXXXXXXXXXXXXXXXXXXXXXXXXXXXXXXXXXXXXXXXXXXXXXXXXXXXXXXXXXXXXXXXXXXXXXXXXXXXXXXXXXXXXXXXXX
