-----------------------------------------------------------------------------------------------------
-----------------------------------------------------------------------------------------------------
-------------C---------------------------------------------------------------------------------------
--P-P-P-----XXX--------------------------------------------------------------------------------------
-----------------------------------------------------------------------------------------------------
-----------------------------BBBBBB------------------------------------------------------------------
--------E--------------------------------XXX-XXXX----------------------------------------------------
XXXXXXXXXX-------------------------------C----------------------------XX-----------------------------
----------------------------------------------------------------------XX-----------------B-----------
---------CCC-----E--------X-XXXXXXXX----------------------------------XX-----------------------------
-----------E----XX--------XXXX--------E-------------------E--------X--XX------E----------------------
XXXXXXXXXXXXX---XX--------XX---------XX---------------------------XX--XX-----XX----------------------
----------------XX------EEX----------XX--------------------------XXX--XX-----XX----------------------
----------------XXXXXXXXXXX---XXXXXXXXXX------XXXXXXXXXXXXXXXXXXXXXXX-X--XXXXXXXXXXXXXXXXXXXXXXXX---X
