---------------------------------------------------------------------------------------------------------------------
---------------------------------------------------------------------------------------------------------------------
---------------------------------------------------------------------------------------------------------------------
---------------------------------------------------------------------------------------------------------------------
---------------------------------------------------------------------------------------------------------------------
---------------C-----------CC--C---------------C-CC--C---------C-----------------------------------------------------
--------------C-----------------C------C-------------------C-C--C-------C--------C------------C----------------------
--------------------------C------C--C-------CCC----CC------------C--C--C------C----------------C--C------------------
---------C----------------B-B-P-B-CC-----CCC---BPPBBB---CCC------B---CC---C-----C---CC-------C--CC-C-----------------
-------CC---------C---C--C----------------------------C------------C--BBB-----------------CC-------------------------
------P-P----C--------------------B----------P---------C----------BBPB-------C-----C---CC----------------------------
-----------------E----P-BB---EE----------------EE----E-----------S--------B------------BBP---------------------------
--------------XXXX--------XXXXXXXX-------E----XXXXXXXX-----ES-XXXX-----SE-----E----------------SSE-------------------
------E-------XXXX--------XXXXXXXXE-E-XXXXS---XXXXXXXX----XXXXXXXXE---XXXX----XXXX------------XXXXS------------------
XXXXXXXXXX----XXXX--------XXXXXXXXXXXXXXXXXXXXXXXXXXXX----XXXXXXXXXXXXXXXX----XXXX------------XXXXXXXXXXXX-----------
