-----------------------------------------------------------------------------------------------------
-----------------------------------------------------------------------------------------------------
-----------------------------------------------------------------------------------------------------
-----------------------------------------------------------------------------------------------------
-----------------------------------------------------------------------------------------------------
-X--------------------------------------------------BBBB---------------------------------------------
XX---------------------------------------------------------------------------------------------------
XX-------------------------------------------------E-------------------------------------------------
XX---------------------------------------XXX---------------------------------------------------E-----
XX---------XX----------------------XX------------BPB--BB----------------------------------E---XX-----
XX--------XXX----------------------XX-XXXX-----------------------------------------------XX---XX-----
XX-------XXXXX---------------------XX---------------------------------------------------------XX-----
XX-----XXXXXXX-E-E--------X-----E--XX-------------------E-------------------------------------XX---E-
XXXXXXXXXXXXXXXXXXXXXXXXXXXXXXXXXXXX----------XXXXXXXXXXXXXXXXXXXXXXXXXXX--XXXXXXXXXXXXXXXXXXXXXXXXXX
