---------------------------------------------------------------------------------------------------------------------
---------------------------------------------------------------------------------------------------------------------
---------------------------------------------------------------------------------------------------------------------
---------------------------------------------------------------------------------------------------------------------
---------------------------------------------------------------------------------------------------------------------
----------CC-----------------------CC------------------------C-C--------------C---C----------------C-----------------
-------------C-----------------CC------C-C------C----------------C---------C-----C--C--------------------------------
-------C----C--CCC--C------------C--------C---C---C-----CC----C-C------C----C--C---C-C------------C------------------
----------B-BB--------CC-------------------C-C-C---C--CC-------BP--C-C----B------------CC---C-C----------------------
------BBBP----C---C--C---C-----B------------C--BB---C--------------------------------------C-C-C---------------------
--------------BB-------------C--------------BP----------------------BP-BPP---------------CBBB---C--------------------
-----------SE---------------BB-----ES----E-----------------SS----E-----------ES----EE---B---------SE-----------------
------S---XXXX----------------S---XXXXXXXX-----E-E--------XXXXXXXX--------XXXXXXXXXXXX------------XXXX---------------
XXXXXXXXXXXXXX---SE-----------XXXXXXXXXXXXE---XXXX---SE---XXXXXXXXS----EE-XXXXXXXXXXXX----S-------XXXX---------------
XXXXXXXXXXXXXXXXXXXXXX--------XXXXXXXXXXXXXXXXXXXXXXXXXXXXXXXXXXXXXXXXXXXXXXXXXXXXXXXX----XXXX----XXXX---------------
