---------------------------------------------------------------------------------------------------------------------
---------------------------------------------------------------------------------------------------------------------
---------------------------------------------------------------------------------------------------------------------
---------------------------------------------------------------------------------------------------------------------
---------------------------------------------------------------------------------------------------------------------
---------------------------------C----CC----------------------------------------------------------C------------------
--------------C-C-C--C--C-C-----C-C-C------C----------C-C--------------C-----------C--C-----CC-----------------------
--------------------C----C----C----C-C--CC--CC---C---------CCC-C-------------C------CC----CC-------------------------
---------------C---C--------CC--BBB-------C----CC--------C----C-C---C---CC-----C--B-BP-C--------C--------------------
------C------C-BBBB--------B-P----------------C----C-C-----------CCC--B---C---C-C-----B--P----C----------------------
------------C---------------------------------B-PB-------------BB----------------B---------------C-------------------
------------PB----------------S----SE----S--------BB-------EE------BBB-------------EE-------------SE-----------------
-----------------EE----SE----SXXXXXXXXXXXXE-----------E---XXXX---------EE---------XXXX---EE-------XXXX---------------
------S-------XXXXXXXXXXXXXXXXXXXXXXXXXXXXXXXX-EE-----XXXXXXXX---E----XXXX---EE---XXXXXXXXXXXX----XXXX---------------
XXXXXXXXXX----XXXXXXXXXXXXXXXXXXXXXXXXXXXXXXXXXXXX----XXXXXXXXXXXX----XXXXXXXXXXXXXXXXXXXXXXXX----XXXXXXXX-----------
