-----------------------------------------------------------------------------------------------------
-----------------------------------------------------------------------------------------------------
-----------------------------------------------------------------------------------------------------
-----------------------------------------------------------------------------------------------------
----X-----------------------------------------------------------------------------CC---------------E-
BB-------------E----------------------------BBB----B------------------------------------B----------E-
--------------XX-------------------------------------------------------------------------------------
--------------XX---------------------------E---------------------------------------------------------
--------------XX-----E-------------------------------------------------B-----------------------------
XXX----X------XXBBB-XX-----------XX---XXBBPB-----BPB------------------E------------XX--BB------------
X---X---------------XX--E--------XX--XXX------------------X-------E---E------------------------------
--------------------XX-XX-------XXX--XXX----------------XXX------------------------------------------
--------------E-----XX-XX-----XXXXX--XXX----------E-E---XXX--------------E---E-E-----X---------------
-XX--------XXXXXXXXXXXXXXXXXXXXXXXXXXXXXXXXXXXXXXXXXXXXXX----XXXXXXXXXXXXXXXXXXXX------XXX---XXXXX---
