-----------------------------------------------------------------------------------------------------
-----------------------------------------------------------------------------------------------------
-----------------------------------------------------------------------------------------------------
-----------------------------------------------------------------------------------------------------
-----------------------------------------------------------------------------------------------------
X-----BB--------------------------------------------BBB--------B---PBBB-------------------------PBBBB
X--------------------XBBB------------CC--------------------------------------------------------------
X-------------------XXX------------------------------------------------------------------------------
X------------E-----XXXB------------------------------------------------------------------------------
X------EBB--XX-XX-XXXXX------------------------E---------------------E----------------------------E--
X--E--XX----XX-XXXXXXXX-BB--------------------XX-----E--------------XX------------------E--------XX--
--XX--XX----XX-XXXXXXXX-------B---------------XX----XX------B-------XX-----------------XX--------XX--
--XX--XX----XX-XXXXXXXX-------b---------E-XX--XX----XX------b-------XX-----------------XX-E------XX--
XXXXXXXXXXXXXXXXXXXXXXXXX--XXXXXXXXXXXXXXXXXXXXXXXXXXXXXXXXXXXXXXXXXXXXXXXXXXXXXXXXXXXXXXXXXXXXXXXXXX
