-----------------------------------------------------------------------------------------------------
-----------------------------------------------------------------------------------------------------
BBBBBBBBBBBBBBB---------------------------------------------------------------BBBBBBBBBBBBBBBBBBBBBBB
BBB----------------------C---------------------------------------------------------------------------
BBB--------------------------------------------------------------------------------------------------
-BB---------------------BB-------------BB------BBB---------------------B-----------------------------
-BB--------------------------------------------------------------------------------------------------
-BB--------------------------------------------------------------------------------------------------
-BB---------------------------------------------------------------E----------------------------------
-BB--E-------BB---------B---------------BBBBBBBBBBB-------------EXX---B------------------------------
----XX-----------------------------------------------XX--------XXXX----------------------------------
----XX-----------------------------------------------XX--------XXXX----------------------------------
--E-XX-----E-----------E-E--------E-----EE-----------XX---E----XXXX-EEE--X-----------------------E---
XXXXXXXXXXXXXXX-XX----XXXXXXXXXXXXXXXXXXXXXXXXXXXXXXXXXXXXXXXXXXXXXXXXXXXXXXXXXXXXXXXXXXXXXX--XXXXXXX
