--------------------------------------------------------------------------------------------------------------------
--------------------------------------------------------------------------------------------------------------------
--------------------------------------------------------------------------------------------------------------------
--------------------------------------------------------------------------------------------------------------------
--------------------------------------------------------------------------------------------------------------------
------------------BBP--------------------------------------------------------------------BB----BBBBBB---------------
--------------------------------------------------------------------------------------------------------------------
--------------------------------------------------------------------------------------------------------------------
--------------------------------------------------------------------------------------------------------------------
-----------------B--P---BB-P---------B--------------------------------------------------------B---------------------
----------------------------------X---------------------------------------------------------------------------------
---------------X--------------SXXXX-----SXX-------------------------------------------------------------------------
---------------E---------C-C--E-XXX-----EEX-------------------------------------------------------------------------
XXXXXXXXXXXXXXXXXXXXXXXXXXXXXXXXXXXXXXXXXXXXXXXXXXXXXXXXXXXXXXXXXXXXXXXXX-----------------------XXXXXXXXXXXXXXXXXXXX
