---------------------------------------------------------------------------------------------------------------------
---------------------------------------------------------------------------------------------------------------------
---------------------------------------------------------------------------------------------------------------------
---------------------------------------------------------------------------------------------------------------------
---------------------------------------------------------------------------------------------------------------------
---------C----------------------CC-------------C-C----------------C------CC-CC--------------------CC-----------------
------CC---------C------------C------C------CCC-C------------C---C-C-C-CC--C---------------C-C-----------------------
--------C----C--C-CC----------------C---------------------C----C----------------C-C-----C-C-----C--------------------
--------------C-------CC---C---PB-CC--C--CC---B--B-------C----------BBPBB-----C----CCC---C-------C-------------------
-----------CC------------C--C-----------C---BB----C-CC--C---------------------------B-CC--BBBP-----------------------
----------BBB-----------------------------------------CC------------------------------PB-----------------------------
-------E----------E------B-P-PS----------------EE-BPBB-----EE-----E----ES----E---------------------S-----------------
XXXXXXXXXX-------EXXXX--------XXXX-EE-----E---XXXX--------XXXX---EXXXXXXXXXXXX-----EE-----E----SESXXXX---------------
XXXXXXXXXX-SS-XXXXXXXX--------XXXXXXXX----XXXXXXXX--------XXXXXXXXXXXXXXXXXXXXS---XXXX---SXXXXXXXXXXXX---------------
XXXXXXXXXXXXXXXXXXXXXX--------XXXXXXXX----XXXXXXXX--------XXXXXXXXXXXXXXXXXXXXXXXXXXXXXXXXXXXXXXXXXXXX---------------
