-----------------------------------------------------------------------------------------------------
-----------------------------------------------------------------------------------------------------
-------------------------------------B---------------BBBBBBB-----------------------------------------
-------------------------------------B---------------------------------------------------------------
-------------------------------------B------------------------------------------------------E--------
BB-----------------------------------B-------------------------------XXXXXX---------BBBBBBBBBBB------
-------------------------------------B------------------------------XXXXXXX--------------------------
-------------------------------------B-----------------------------XXXXXXXX--------------------------
BB-----------------------------------B--E--------------------------XXXXXXXX--------------------------
------------E------------------------B-XX--------------E----------XXXXXXXXX--------X-BB--BBBBBB--B---
-----------XX---------------E--------B-XX-------------XX---B------XXXXXXXXX-------XX-----------------
-----------XX--------------XX--------B-XX---------B---XX---B------XXXXXXXXX------XXX-----------------
-----------XX----EEEE------XX---E----B-XX---------b---XX---B--E---XXXXXXXXX-----XXXX---E-------------
--XXXXXXXXXXXXXXXXXXXXXXXXXXXXXXXXXXXXXXXXXXXXXXXXXXXXXXXX-XXXXXX-XXXXXXXXXXXXXXXXXXXXXXXXXXXXXXXXXXX
