--------------------------------------------------------------------------------------------------------------------
--------------------------------------------------------------------------------------------------------------------
--------------------------------------------------------------------------------------------------------------------
------------------------X-------------------------------------------------------------------------------------------
--------------------------------------------------------------------------------------------------------------------
------------------------------------------------------------------------------------------BBBBBP--------------------
--------------------------------------------------------------------------------------------------------------------
--------------------------------------------------------------------------------------------------------------------
--------------------------------------------------------------------------------------------------------------------
------------------------------------------------------------------------------P--P-----BB----B---X------------------
--------------------------------------------------------------------------------------------------------------------
-------------------------------------------------------------------------SXX---------------------X------------------
-------------------------------------------------------------------------EEXC-C-----C-----------CCC-----------------
XXXXXXXXXXXXXXXXXXX-------------------XXXXXXXXXXXXXXXXXXXXXXXXXXXXXXXXXXXXXXXXXXXXXXXXXXXXXXXXXXXXXXXXXXXXXXXXXXXXXX
