---------------------------------------------------------------------------------------------------------------------
---------------------------------------------------------------------------------------------------------------------
---------------------------------------------------------------------------------------------------------------------
---------------------------------------------------------------------------------------------------------------------
---------------------------------------------------------------------------------------------------------------------
---------C----------C-------------------------------------------------------------C---------------C------------------
---------------------------C------------------C-------------------CC------C--C-CC--C-C----C--------------------------
------C-C---------------CCC-C----C---------C---C-------C-------CCC-------------------------C--C----C-----------------
------B-----C-CC--------------CCC-------C-C-C-----C------C------------C-C--C----------C-----CC-C-C-------------------
-----------C-C--C-------BPPBPB-------C---C------B-----C----C---------B-C--BP--------------BBBB-----------------------
-----------------C------------BBBP--C---------------CC-------C-----------C-------------C-C---------------------------
------E---BB------E-------------------------------PPBB-----------S----PBB-----S----ES-B-PB--------EE-----------------
XXXXXXXXXX--------XXXX-SE----S-----------------SE-------------XXXXS----------EXXXXXXXX----E----EE-XXXXXXXX-----------
XXXXXXXXXX--------XXXXXXXXXXXXS-----------S---XXXX----S-------XXXXXXXX----XXXXXXXXXXXX----XXXXXXXXXXXXXXXX-----------
XXXXXXXXXX--------XXXXXXXXXXXXXXXX--------XXXXXXXX----XXXX----XXXXXXXX----XXXXXXXXXXXX----XXXXXXXXXXXXXXXX-----------
