-----------------------------------------------------------------------------------------------------
-----------------------------------------------------------------------------------------------------
BBBBBBBBBBBBBBBBBBBBBBBBBBBBBBBBBBBBBBBBBBBBBBBBBBBBBBBBBBBBBBBBBBBBBBBBBBBBBBBBBBBBBBBBBBBBBBBBBBBBB
------------------------------------------------BBB-------BBBBBBBBBBBBBBB----------------------------
------------------------------------------------BBB-------BBBBBBBBBBBBBBB----------------------------
--------CCCCCCC-CCCCCCCC-C--------------BBB--B---BB----------B--------B----B-------------------------
---------------------------------------------B---BB----------B--------B------------------------------
--B-B-B-BBBBBBB-BBBBBBBB-B-B-----------------B---BB----------B--------B------------------------------
--BCBCBCB-B---BCB------BCBCB-----------------B---BB-------CCCBCCCCCCCCBCPP------------------B--------
--BBBBBBB-B---BBB------BBBBB----XX---E--BBB--B---BB-------BBBBBBBBBBBBBBB--B----------X-------------E
-------------------------------XXX--XX----------------------------------------------XXX------------XX
-----------------------------XXXXX--XX---------------------------------------------XXXX------------XX
---------E-EEE---EEEEEE------XXXXX--XX------------E--------E---E-E--E------------XXXXXX-E-------E--XX
XXXXXXXXXXXXXXXXXXXXXXXXXXXXXXXXXXXXXXXXXXXXXXXXXXXXXXX--XXXXXXXXXXXXXXXXXXXXXXXXXXXXXXXXX-XXXXXXXXXX
