---------------------------------------------------------------------------------------------------------------------
---------------------------------------------------------------------------------------------------------------------
---------------------------------------------------------------------------------------------------------------------
---------------------------------------------------------------------------------------------------------------------
---------------------------------------------------------------------------------------------------------------------
------------------------------------------------------------------------C-----------CC-----CC------------------------
-----------------------C-------C---CC-----------------------C-----CC--CC-C--------CC--C------------------------------
----------C-----C--C--C-CC----C--C-----C-C----C-C----------C---------------------------CC--------C-------------------
------------C-C--C---C-----C-C-------C----C-C------C-C-CC-------C---C-BBB----------------BBBB--CC--------------------
-------------C------------C-C-BB-B-P----C------BBBC------C----------BB----CCC---C-------------BB---------------------
------CCC---B-------------B-B-------------------------C-------CC-C---------------C-----------------------------------
------PBBP----------------------------------------PB-P-P---SS----------EE----------EE----ES--------------------------
-----------------E-----EE-----E----ES----------EE---------XXXX----E---XXXX--------XXXXXXXXXXXX-SES-------------------
-----------ES-XXXXS---XXXX---SXXXXXXXX---S----XXXX--------XXXX----XXXXXXXX--------XXXXXXXXXXXXXXXX-------------------
XXXXXX----XXXXXXXXXXXXXXXXXXXXXXXXXXXXXXXX----XXXX--------XXXX----XXXXXXXX--------XXXXXXXXXXXXXXXX-------------------
