---------------------------------------------------------------------------------------------------------------------
---------------------------------------------------------------------------------------------------------------------
---------------------------------------------------------------------------------------------------------------------
---------------------------------------------------------------------------------------------------------------------
---------------------------------------------------------------------------------------------------------------------
-----------C-C----------------CC-----------C-C----------------CC-----------------------------------------------------
---------------C----C-C----C-C---CC--C------C-------C------CC---------------------------C--C-------------------------
------C-------C-C----C-CCCC-----C--CC-----C---C----C-C----C-----CCC--CC-------C---C--C---C---CC----------------------
---------CBB------C---------PBB-PBPBB----C---B--C-PB-B-------C-----C---CCC------------CC----------CC-----------------
-------B-B-----------------------------C------PBBB------------------------CC-C-----------BBB---C-C-------------------
----------------------------------------C-------------C-CC---------BPPB-BB--C-----------------PB---------------------
-----------SE----------------SE----EE-----E----------EB----------S---------------------------------------------------
------E---XXXX---ES----SS-XXXXXXXXXXXX----XXXX-ES-XXXX-----EE-XXXX------------E----ES----ES-------ES-----------------
XXXXXXXXXXXXXXXXXXXXXXXXXXXXXXXXXXXXXX----XXXXXXXXXXXX----XXXXXXXXS----SE-----XXXXXXXXXXXXXXXX-S-EXXXX---------------
XXXXXXXXXXXXXXXXXXXXXXXXXXXXXXXXXXXXXX----XXXXXXXXXXXX----XXXXXXXXXXXXXXXX----XXXXXXXXXXXXXXXXXXXXXXXX---------------
