-----------------------------------------------------------------------------------------------------
-----------------------------------------------------------------------------------------------------
--------------------------------------------------------------------------------BBBB-----------------
---------------------------P-------------------------------------------------------------------------
--------------------CCC---------------------------E-----CC-----------------------P-------------------
-BBBBB------------XXXXXX--------X------------BBB--E-----------------X-----------BPP---X--------------
--------------C----------C---------------E--------------------------X--------------------------------
------------------------XXXXXX----------XX-------------------------XX--------------------------------
----------------------------------------XX------------------------XXX--------------------------------
B---------------------------------------XXX-XXXXX------X---------XXXX-----------BBBB------E----------
------------------------C-------------------X--------------------XXXX---------------------E----------
-----------------------XXXXXXXXX------------X------------XX------XXXX--------------------------------
E-------------------------------------------X--------------------XXXX-------------------E-----E------
XX----XXXXXX--XX------------------X-XXXXXXXXXXXXX---XX------XXXXXXXXXXXXXXXXXXX-XXXX-XXXXXXXXXXXXXXXX
