-----------------------------------------------------------------------------------------------------
-----------------------------------------------------------------------------------------------------
---------------------------------------------------------------E-------------------------------------
-----------------------------------------------------------------------------------------------------
-----------------------------------------------------------------------------------------------------
-------------------BB-------------------B------------------------------------------------------------
-----------------------------------------------------------------------------------------------------
------------------------------------------------------------------------X----------------------------
----------E--------------------B---------------------------------------XX--------------XX---BB-------
B----B---XX-------B-----------E--------B------------------------------XXX-------------XXX------------
---------XX-------------------E------------------E-E---------------X-XXXX-----B------XXXX------------
---------XX-------------------------------------XXXX--------------XXXXXXX-----b--XX-XXXXX----------B-
E------E-XX------EE--------------EE---EE-----E--XXXX------X----XXXXXXXXXX-----B--XXXXXXXX-X-BBBBB--b-
XXXXXXXXXXXXXXXXXXXXXXXXXXXXXXXXXXXXXXXXXXXXXXXXXXXXXXX-XXXXXXXXXXXXXXXXX--XXXXXXXXXXXXX--------XXXXX
