--------------------------------------------------------------------------------------------------------------------
--------------------------------------------------------------------------------------------------------------------
--------------------------------------------------------------------------------------------------------------------
--------------------------------------------------------------------------------------------------------------------
--------------------------------------------------------------------------------------------------------------------
-----------------------XXXX-------------------------------------------------BBBP------------------BBP---------------
--------------------------------------------------------------------------------------------------------------------
--------------------------------------------------------------------------------------------------------------------
--------------------------------------------------------------------------------------------------------------------
----------------PB------B-------XX---XXX--X---------------------------------------------SX--BBB---------------------
--------------------------------XX--XX----X--------------------------------------------EEX--------------------------
--------------------------------XXXXXX---XX--------------------------------------------EEX--------------------------
---------------------C------C-C-EXXXXX--XXX---------------------------------------C--C-EEX--------------------------
XXXXXXXXXXXXXXXXXX---XXX---XXXXXXXXXXXXXXXXXXXXXXXXXXXXXXXXXXXXXXXXXXXXXXXXXXXXXXXXXXXXXXXXXXXXXXXXXXXXXXXXXXXXXXXXX
