-----------------------------------------------------------------------------------------------------
-----------------------------------------------------------------------------------------------------
-----------------------------------------------------------------------------------------------BBBBBB
-----------------------------------------------------------------------------------------------------
----------------------------------------------------------------------------------------X------------
BBBBBB-----------------------------------------------BBBBBBB-------BB--------------------------------
------------------------------------------------------------------------------------------CC---------
--------------------------------------------C-------------------------------X------------------------
-------C-------------------------------------------------------------------XX------------------------
--------------------------------------XBBBBB---------------EBB---BBBB--XXXXXX------E-------------E--E
-------------------------------------XX-------------------XX-----------XXXXXX-----XX----X-------XX-XX
X----------------------B-------------XX-------------------XX-----------XXXXXX-----XX------------XX-XX
X-----------------EE---b--E----------XX-------E-----------XX----------EXXXXXX-----XXEE----------XX-XX
XXXXXXXXXXXXXXXXXXXXXXXXXXXXXXXXXXXX-XXXXXXXXXXXXXXXXXXXXXXXXXXXXXXXXXXXXXXXXXXXXXXXXXX---XXXXXXXXXXX
