-----------------------------------------------------------------------------------------------------
-----------------------------------------------------------------------------------------------------
-----------------------------------------------------------------------------------------------------
C-C-C------------------------------------------------------------------------------------------------
XXXXXX-----------------------------------------------------------------------------------------------
-----------------------------------------------------------------------------------------------------
-----------------------------CCCC--------------------------------------------------------------------
---------------------------E----------------------------------------------------X--------------------
--------------------------XX----------------------------------------------------X--------------------
--------------------------XX----------------------------------------------------X--E-----------------
--------------------------XX----------------------------------------------------X-XX-----------------
--------------------------XX--------------------------------------XX------------X-XX-----------------
-----------E--------X-----XX--------------X----E------------------XX--------X---X-XX-----------------
XXXXXXXXXXXXXXXXXXXXXXXXXXXXXXXXXXXXXXXXXXXXXXXXXXX---XXXXXXXXXXXXXXXXXXXXXXXXX-XXXXXXXXXXXXXXXXXXXXX
