---------------------------------------------------------------------------------------------------------------------
---------------------------------------------------------------------------------------------------------------------
---------------------------------------------------------------------------------------------------------------------
---------------------------------------------------------------------------------------------------------------------
---------------------------------------------------------------------------------------------------------------------
------CC---------------------------------------C---------------------C-----------------C-----------------------------
----------CCC-----C-CCCC-----------C-C-----C--C-------CC-C-C---------------------------------------------------------
--------CC---------------C-C----------------------C-C----------C--C-C-----------------C-C--------C-------------------
---------------C---C----C------C-------------CP-BB--------C---C--C--PB--C-CC---C------BBBB--CC-CC--------------------
----------BBB------------BC------C----------B--------CP-B-------C-----C-------C--C-C----------C---C------------------
-----------------C--------BBP-C-C-----CC-----------BP------------------------C------CC--------B----------------------
------E-----------------------PBBB-------------EE-----------------E----B-------------B--E-BBPB-----------------------
XXXXXXXXXX-SE-----S----EE----------SS-----E---XXXX----E---S-E-----XXXX----------------XXXX------------XXXX-----------
XXXXXXXXXXXXXX----XXXXXXXX---E----XXXX----XXXXXXXX---EXXXXXXXX---EXXXX--------E-------XXXX-----SEESE--XXXX-----------
XXXXXXXXXXXXXX----XXXXXXXXXXXX----XXXX----XXXXXXXXXXXXXXXXXXXXXXXXXXXX--------XXXX----XXXX----XXXXXXXXXXXX-----------
