--------------------------------------------------------------------------------------------------------------------
--------------------------------------------------------------------------------------------------------------------
--------------------------------------------------------------------------------------------------------------------
--------------------------------------------------------------------------------------------------------------------
--------------------------------------------------------------------------------------------------------------------
--------------------------------BBB-BPB---------------------------------------BBBB----------------------------------
--------------------------------------------------------------------------------------------------------------------
--------------------------------------------------------------------------------------------------------------------
--------------------------------------------------------------------------------------------------------------------
-------------------BBBP------SXX-------X----------------------------------------------------X-----------------------
-----------------------------EXX------XX---------------------------------------------------XXX----------------------
-----------------------------EEX------XXX-----------------------------------------------SXXXX-----X-----------------
----------------X----------C-EEX----X-XXX-----------------------------------------------EXXXX---XXX-----------------
XXXXXXXXXXXXXXXXXXXXXXXXXXXXXXXXXXXXXXXXXXXXXXXXXXXXXXXXXXXXXXXXXXXXXXXXXXXXXXXXX-XXXXXXXXXXXXXXXXXXXXXXXXXXXXXXXXXX
