--------------------------------------------------------------------------------------------------------------------
--------------------------------------------------------------------------------------------------------------------
--------------------------------------------------------------------------------------------------------------------
--------------------------------------------------------------------------------------------------------------------
--------------------------------------------------------------------------------------------------------------------
------------------BB-P-----------------------------------------------------------------------BBP-BBBB---------------
--------------------------------------------------------------------------------------------------------------------
--------------------------------------------------------------------------------------------------------------------
--------------------------------------------------------------------------------------------------------------------
--------------------BB--------------X--XX----------------------------------B-----------BB----BB----BB---------------
----------------------------------XX-X-XXX--------------------------------------------------------------------------
------------------------------SXX-XXXXXXXX--------------------------------------------------------------------------
----------------C-C-C---------EEXCXXXXXXXX-------------------------------------------C--C----------C----------------
XXXXXXXXXXXXXXXXXXXXXXXXXXXXXXXXXXXXXXXXXXXXXXXXXXXXXXXXXXXXXXXXXXXXXXXXXXXXXXXXXXXXXXXXXXXXXXXXXXXXXXXXXXXXXXXXXXXX
