---------------------------------------------------------------------------------------------------------------------
---------------------------------------------------------------------------------------------------------------------
---------------------------------------------------------------------------------------------------------------------
---------------------------------------------------------------------------------------------------------------------
---------------------------------------------------------------------------------------------------------------------
-----------CC---------------------------------------------------------C------------------------C-C-------------------
-------------C-C----------CC----------C--C----------C-------------CC-C-C-CC-C------C-C-CC--C-C--C--------------------
------C-CCC------C-----------C----C--C-------------C----C-C--C----------C-----------C-C-----C------------------------
----------B-BP--C----C--------------C-------CC-C-C---C------------PBB-PB-------C--C----------------------------------
--------------P-------C---B--P--CC--------C-------BPB------------C------------C--C--BPBBBBBB-------------------------
------------------------C------C-----------C--C-C---------------BB---------------------------------------------------
-----------ES-----------PP----PB------------BBPPBB----------------E---S-S----------------------ES--------------------
----------XXXX---E-----------E-----SE----S-----------E-----EE-----XXXXXXXX---E-----SS----EE---XXXXES-----------------
------E---XXXXXXXXE-------XXXX----XXXXXXXX--------XXXXS---XXXX---EXXXXXXXXXXXXE---XXXXXXXXXXXXXXXXXXXX---------------
XXXXXXXXXXXXXXXXXXXXXX----XXXX----XXXXXXXX--------XXXXXXXXXXXXXXXXXXXXXXXXXXXXXXXXXXXXXXXXXXXXXXXXXXXXXXXX-----------
