-----------------------------------------------------------------------------------------------------
XXXX-------------------------------------------------------------------------------------------------
-----------------------------------------------------------------------------------------------------
---------------B-------------------------------------------------------------------------------------
-----------------------------------------------------------------------------------------------------
--------E---E----CC------------------B-----B---------------------------------------------------------
------XXXXXXXXX--------------------------------------------------------------------------------------
------------------------------------------------E----------------------------------------------------
---------------------------XBB-----------------XX---------------------E------BB----------------------
-------------------XXX----XXX------------XXXXX-XX--------------------XX---------------------------XX-
--------------------------XXX---------E--XX----XX--------------------XX------------------------------
XXXX----------------------XXX--------XX--XX----XX--------------------XX------------------------------
--------------------------XXX--------XX--XX----XX----E-E-------------XX------BBBB--------------E-----
-------------------------XXX----XXXXXXXXXXXXX--XXXXXXXXXXXXXXXXXXX--XXXXXX------XXXXXXXXXXXXXXXXXX--X
