---------------------------------------------------------------------------------------------------------------------
---------------------------------------------------------------------------------------------------------------------
---------------------------------------------------------------------------------------------------------------------
---------------------------------------------------------------------------------------------------------------------
---------------------------------------------------------------------------------------------------------------------
------------------C----------C-----------C-----C-C------CC----C----C--------------C-------C--------------------------
-------------------CC-----CC----C---C-C---------C------C--------C-C------C---------CCCCC----C------------------------
--------------CC-----C-C-------C--------------C---C-C-C--------C-----C-------------------------CCC-------------------
------C--C------CC-----------P---C---C--------BBPB-C-CB--------------B----C--C--C--------CBB-BC---CC-----------------
-------------C--------C-CC----BB-BBB-------C-----------------C--------BP-B-C--CC-------BP----------------------------
-------C--BBBB----------------------------C-CC----BPB------CC--------------------C------------PB---------------------
--------BB---------E---------S-----------E-----SS-----E----------SS---------P------ES-----E--------------------------
-----------------EXXXX----XXXXE----EE-XXXX----XXXX----XXXX----XXXXXXXX-SE---------XXXX---SXXXX-----------------------
-----------SE-XXXXXXXX-SE-XXXXXXXXXXXXXXXX----XXXX---EXXXX----XXXXXXXXXXXX--------XXXXXXXXXXXX-EEES------------------
XXXXXX----XXXXXXXXXXXXXXXXXXXXXXXXXXXXXXXX----XXXXXXXXXXXX----XXXXXXXXXXXX--------XXXXXXXXXXXXXXXXXXXXXXXX-----------
