---------------------------------------------------------------------------------------------------------------------
---------------------------------------------------------------------------------------------------------------------
---------------------------------------------------------------------------------------------------------------------
---------------------------------------------------------------------------------------------------------------------
---------------------------------------------------------------------------------------------------------------------
------C------------------------------------------CC-C-C--C-C--------------C-C-----CC---------------------------------
-------C-C------------C-CC------CC-C----------C-C------C--C------------------C---C--C--------------------------------
--------C------CC------C---CC-CC--------CC-----C------------CCC----------C-----------C----CC------C------------------
--------BBCC--C----C-----------B----CC----C-C-BBB-BPBBBB-------C----C-C-C---------BBBB------C------------------------
---------------------C-------C----------------------------------C-----BB--------------C------CBBB--------------------
-----------BPP----C-C------------------------C--------------------------------------------BB-B-----------------------
------E-----------------------S--------------B-ES----SS----SS------B-B-------SE----ES-BBBB---------------------------
XXXXXXXXXX-------------EE-----XXXX-EE---------XXXXXXXXXXXXXXXX---------EE-XXXXXXXXXXXX--------E-EE----XXXX-----------
XXXXXXXXXX-EE----E----XXXX---SXXXXXXXX---E----XXXXXXXXXXXXXXXX---E----XXXXXXXXXXXXXXXX----S---XXXX----XXXX-----------
XXXXXXXXXXXXXXXXXX----XXXXXXXXXXXXXXXXXXXX----XXXXXXXXXXXXXXXXXXXX----XXXXXXXXXXXXXXXX----XXXXXXXXXXXXXXXX-----------
