--------------------------------------------------------------------------------------------------------------------
-----------------------X--------------------------------------------------------------------------------------------
----------------------XX--------------------------------------------------------------------------------------------
---------------------XXXX-------------------------------------------------------------------------------------------
---------------------XXXX-------------------------------------------------------------------------------------------
---------------------XXXXXXX---------BBBBBB------------------------------------B------------------------------------
--------------------------------------------------------------------------------------------------------------------
------------------------------------C-------------------------------------------------------------------------------
--------------------------------------------------------------------------------------------------------------------
----------------------------------B-B------------------------------------------------P---------B--------------------
--------------------------------------------------------------------------------------------------------------------
---------------------------------------------------------------------------------------SXX--------------------------
------------------------------C---------------------------------------------------CC-C-EEX-CX-----------------------
XXXXXXXXXXXXXXXXXX---XX---XXXXXXXXXXXXXXXXXXXXXXXXXXXXXXXXXXXXXXXXXXXXXXXXXXXXXXXXXXXXXXXXXXXXXXXXXXXXXXXXXXXXXXXXXX
