--------------------------------------------------------------------------------------------------------------------
--------------------------------------------------------------------------------------------------------------------
--------------------------------------------------------------------------------------------------------------------
--------------------------------------------------------------------------------------------------------------------
--------------------------------------------------------------------------------------------------------------------
------------------------------------BBBBBBB------------------------------BB---BBB-----------------------------------
--------------------------------------------------------------------------------------------------------------------
--------------------------------------------------------------------------------------------------------------------
--------------------------------------------------------------------------------------------------------------------
--------------------P---B-----SX---B--------------------------------------------------------XXXX--------------------
------------------------------EX-----------------------------------------------------------XXX----------------------
---------------SXX------------EX--------------------------------------------------------SXXXX-----SXX---------------
---------------EEX--C----C-C--EX--------C-----------------------------------------------EXXXX-----EXX---------------
XXXXXXXXXXXXXXXXXXXXXXXXXXXXXXXXXXXXXXXXXXXXXXXXXXXXXXXXXXXXXXXXXXXXXXXXXXXXXXX---XX----XXXXXXXXXXXXXXXXXXXXXXXXXXXX
