-----------------------------------------------------------------------------------------------------
-----------------------------------------------------------------------------------------------------
BBBBBBBBBBBBBBBBBBBBBBBBBBBBBBBBBBBBBBBBBBBBBBBBBBBBB------------------------------------------------
BBB-BBBBBBBBB------------BBBBB-----------------------------------------------------------------------
BBB-BBBBBBBBB------------BBBBB-----------------------------------------------------------------------
-----B-------------------BBBBB-------------------------------B------------------------------------XX-
-----B-------------------------------------------------------------------C------------------------XX-
-----B--------------------------------------------------------------------------------------------XX-
-----BCCCCCCPP---------E---------------------B----------------------------------------------------XX-
BBB--BBBBBBBB---------XX------XXXX--------------------------BBBB-----B----------------------------XX-
BBB-------------E-----XX-----XXXXXXX----------------B---------------------------------------------XX-
BBB------------XX-----XX----XXXXXXXX----------------B------------------------------------------------
-------E-E-----XX--E--XX---XXXXXXXXX----------------B---E--------------------------X--------E-E------
XXXXXXXXXXXXXXXXXXXXXXXX--XXXXXXXXX--------XXXXXXXX-XXXXXXXXXXXXXXXXXXXXXXXXXXXXXXXXXXXXXXXXXXXXXXXXX
