-----------------------------------------------------------------------------------------------------
-----------------------------------------------------------------------------------------------------
-----------------------------------------------------------------------------------------------------
-------------------------------------------------------------------------------------------------CC--
-----------------------------------------------------------------------------------------------------
---------------------------------------------------------------------------------------------------X-
-E----------------------------------------------------------------------C-C-C------------------------
XX-----------------------E---------------------------------------------XXXXXXX-----------------------
XX----------------------XX-P-------------------------------------------------------------------------
XX----------------------XX--------------------------E---------E-------------------------------------X
XX----------------------XX----------------E--------XX---------E--------------------------------------
XX----------------------XX-------------------------XX------------------------------------B-----------
XX-EE-E---------------E-XX-----------------X-E-----XX-EE-------------------------E----E--b-----------
XXXXXXXXXXXXXXXXXXXXXXXXXXXXXXXXXXXXXXXXXXXXXXXXXXXXXXXXXXXXXXXXXXXXX--XXXXXXXXXXXXXXXXXXXXXX--------
