---------------------------------------------------------------------------------------------------------------------
---------------------------------------------------------------------------------------------------------------------
---------------------------------------------------------------------------------------------------------------------
---------------------------------------------------------------------------------------------------------------------
---------------------------------------------------------------------------------------------------------------------
-------------------C------------------C-CC---------------------------------------------------------------------------
--------C-----------------------------------CC--------------C------C----------CC-------------------------------------
-------C-C------CCC-C--C-C---------C-C-----C--------------C--C---------CCC------------C----CC------------------------
------C---CC--------------CC-----C--C-----------C-CC------------C-C---B-PB--CC--C-C-CC----C--C-C---------------------
-------P-B------------------CCB-PBC-----------CC--BBBB-C-C----CC-C---B------------------C-------C--------------------
----------PP-PP-----------B--B----B-B---------B-PB----C-------------------CC----------BBBP---------------------------
------------------E----------------------S------------PB---ES----------SE-B-----------------------S------------------
------E-----------XXXX--------E-------XXXXS----------E----XXXX----E---XXXX----E-----------E-------XXXX---------------
XXXXXXXXXX-SE----EXXXX-EE----EXXXX-SE-XXXXXXXX-SE-XXXX----XXXX---EXXXXXXXX----XXXX-SS----SXXXX-SEEXXXXXXXX-----------
XXXXXXXXXXXXXXXXXXXXXXXXXXXXXXXXXXXXXXXXXXXXXXXXXXXXXX----XXXXXXXXXXXXXXXX----XXXXXXXXXXXXXXXXXXXXXXXXXXXX-----------
