-----------------------------------------------------------------------------------------------------
-----------------------------------------------------------------------------------------------------
----P------------------------------------------------------------------------------------------------
-----------------------------------------------------------------------------------------------------
-----------------------------------------------------------------------------------------------------
---------------------------E-------------------------------------------XXX----------------P----------
-------------------------------E---------------E----------------------XXXX---------------------------
----------------------------------XXX---------XX---------------------XXXXX---------------------------
X-BB------------------------------------------XX------E-------------XXXXXX---------------------------
X----------------------------X----------------XX-----XX--E---------XXXXXXX------E--------------------
X---------------------------------------------XX-----XX-XX--------XXXXXXXX-----XX---E----------------
X---------XX----------------------------------XX-----XX-XX-------XXXXXXXXX-----XX--XX----------------
X-------X-XX-------E------CCC--------------E--XX-E---XX-XX------XXXXXXXXXX-----XXE-XX----------------
--XXX--XXXXXXXXXXXXXXXXXX-XXX---------XXXXXXXXXXXXXXXXXXXXX-XXXXXXXXXXXXXXXXXXXXXXXXXXXXXXXXXXXXXX-XX
