--------------------------------------------------------------------------------------------------------------------
--------------------------------------------------------------------------------------------------------------------
--------------------------------------------------------------------------------------------------------------------
--------------------------------------------------------------------------------------------------------------------
------------------------------------------------------------------------------------------------C-------------------
-------------------------------------------------------------------------BBB----B--------------BBBBBB---------------
--------------------------------------------------------------------------------------------------------------------
----------------------------------------------------------------------------------------------C---------------------
--------------------------------------------------------------------------------------------------------------------
------------------------------------XX-XX-X--------------------------------------------P----BBB---------------------
-----------------------------------XXX--XXX-------------------------------------------------------------------------
-------------------------------SXXXXXXXXXXX--------------------------------------------SX---------------------------
--------------------------C----EEXXXXXXXXXX--------------------------------------------E----------------------------
XXXXXXXXXXXXXXXXXXXXXXXXXXXXXXXXXXXXXXXXXXXXXXXXXXXXXXXXXXXXXXXXXXXXXXXXXXXXXXXX--XXXXXXXXXXXXXXXXXXXXXXXXXXXXXXXXXX
