--------------------------------------------------------------------------------------------------------------------
--------------------------------------------------------------------------------------------------------------------
-----------------------X--------------------------------------------------------------------------------------------
----------------------XXX-------------------------------------------------------------------------------------------
----------------------XXX-------------------------------------------------------------------------------------------
----------------------XXXXX----BBB------------------------------------------BBBBBBPB--------------------------------
--------------------------------------------------------------------------------------------------------------------
--------------------------------------------------------------------------------------------------------------------
--------------------------------------------------------------------------------------------------------------------
-------------------------------------XXX-----------------------------------B----------------------------------------
-------------------------------------XX-----------------------------------------------------------------------------
---------------------------------X---XX-------------------------------------------------SXXX------SXX---------------
------------------------------C--XX-XXXX-------------------------------------------C----E-XX------EEX---------------
XXXXXXXXXXXXXXX-----------------XXX--XXXXXXXXXXXXXXXXXXXXXXXXXXXXXXXXXXXXXXXXXXXXXXXXXXXXXXXXXXXXXXXXXXXXXXXXXXXXXXX
