---------------------------------------------------------------------------------------------------------------------
---------------------------------------------------------------------------------------------------------------------
---------------------------------------------------------------------------------------------------------------------
---------------------------------------------------------------------------------------------------------------------
---------------------------------------------------------------------------------------------------------------------
--------C-------------------------------------C-CC-----------------------C-------------------------------------------
-------C---------C----C-C-------------CC--C-C--C-------CCC--------------------C--------C-C---------------------------
-----------------------C-C-----------C--C-------------------------C----C---------C----C-C---C-C----------------------
------------CC-C--CC------------C--CC--------BBBB--C-C-------C--C---C-BB---C-----------------C---C-------------------
--------------B-B----C-----C---C--------------------C-------C------C--------CC-----C--BP-B--------C------------------
--------------------------C---C--C-PBB------------C--------C---C-----P--------------CC----BP-------------------------
------E----B-B-------------BBBBB-B--------S----EE-P--------------------SS-----E--------------------------------------
XXXXXXXXXX-------E-----SS----------------EXXXXXXXX----E---------------XXXX----XXXX-------E---------------------------
XXXXXXXXXX----XXXX----XXXX---------EE-XXXXXXXXXXXX----XXXX--------E---XXXX----XXXX----XXXXS----EE--------------------
XXXXXXXXXX----XXXX----XXXX--------XXXXXXXXXXXXXXXX----XXXX--------XXXXXXXX----XXXX----XXXXXXXXXXXXXXXXXXXX-----------
