-------------------------------------------------------------------------------------------------------------------------------------------------------------------------------------------
------------------------------------------------------------------------------------------------------------------------------------------------------------XXX----------------------------
X-----XXXXXXXXXXXXXXXXXXXXXXXXXXXXXXXXXXXXXXXXXXXXXXXXXXX----------XXXXXXXXXXXXXXXXXXXXXXXXXXXXXXXXXXXXXXXXXXXXX-------XXXX-----XXXXXXXXXXXXXXXXXXXXXXXXXXX-----XXXXXXXXXXXXXXXXXXXXXXXXXXX
X-------------------XXXXXXXXXXXXXXXXXXXXXXXXXXXX----------------------------------------------------------------------------------------------------------------XXXXXXXXXXXXXXXX-----------
X-------------------XXXXXXXXXXXXXXXXXXXXXXXXXXXX-----------XXX----------------------------------------------------------P---------------------------------------XXXXXXXXXXXXXXXX-----------
X-------------------XXXXXXXXXXXXXXXXXXXXXXXXXXXX--BB------------XXX------------E---------------------------------------XPP--------------------------------------XXXXXXXXXXXXXXXX-----E-----
X------------------------------------------------------------------------------S--------------------------------------------XXX---------------------------------X--------------------S-----
X---------------------------------------------------------------X-------------XX--------------------------------------------------------------------------------X-------------------XX-----
X---------------------------P-------------E-EE-----------------X-X------------XX-------X--------------------E----------------------------------E-----------------Poooooooooo--------XX-----
X---------------------XXXXXXPPXXXXXXXXXXXXXXXXXX--BB--BBB---------X------E--XXXXXX---E----E-----------------S------XXX-XXXX----------------E---S-----------------PPXXXXXXXXX----XX--XX-----
X---------------------XXXXX---XXXXXXXXXXXXXXXXXX-------------------------S----XX-----S----S-------------XX-XX--XXX------------------E------S--XX----------XX-------------------XXX--XX---XX
X---------------------XXXXX---XXXXXXXXXXXXXXXXXX------------------------XX----XX----XX---XX------------XXX-XX--XXX------------------S-----XX--XX---------XXXXXX---------------XXXX--XX---XX
X--------------------------oooXXXXXXXXXXXXXXXXXX------------------------XX-E--XX----XX---XX--------E-E-XXX-XX--XXX-----------------XX---E-XX--XX--------XXXX------------EE---XXXXX--XX---XX
XXXXXXXXXXX--XX--X---XXXXXXXXXXXXXXXXXXXXXXXXXXXXXXXXXXXX------XXXXXXXXXXXXXXXXXXXXXXXXXXXXXXXXXXXXXXXXXX--XX--XX------XXXX------XXXXXXXXXXXXXXX--XXXXXXXXX-----XXXXXXXXXXXXXXXXXXXXXXX--XX
