-----------------------------------------------------------------------------------------------------------------------------------------------------
-----------------------------------------------------------------------------------------------------------------------------------------------------
---------------------------------------------------CC------------------------------------------------------------------------------------------------
--------------------------------------------P-----XXXX-------------------C---------------------------------------------------------------------------
-----------------------XX-----------------------------------------------XXX-------------------------CC-----------------------------------------------
----------------------------------------------------------------------------C------C-C----XXX------XXXX----------------------------XXXX--------------
---------------------E----------C----CCC------E--------XXXX--C---C---C------XXXX------------------------C----E---------------XXX---------------------
-----------------XXXXXX-------------------XXXXXX------------XXX-XXX-XXX--------------------------------XXX-------------------------------------------
--------------------------XXX------------------------------------------------------XXXX------------------------------------------------XXXX----------
--------------------------------------XXXX-----CCC--------------------------------------XXX-XXX----------------------EE-E----------------------------
-------------XXXXX-------------------------------E-----------------------------------------------------C----------XXXXXXXXXXXX-----------------------
-----------------------------------------XXXXXXXXXX----------------------------XXXX-------------XXX---XXXXX------------------------------------------
--------------------------CC---XXXXXXX-----------------------------E------------------------------------------------------------------------------XX-
XXXXXXXXXXX--------------XXX--------------------------------XXXXXXXXXXXXXXXX-----------------------------------XXX-------------------------XXXXXXXXXX
