---------------------------------------------------------------------------------------------------------------------------------------------------------------------
---------------------------------------------------------------------------------------------------------------------------------------------------------------------
-----------------------CC-------------------------------------------------------CCC-------------------------------------------------------------------------------E--
--------------------------------------------------B-----------------------------XXXX-----------------------------------------------------------------CC--------------
--------------------------------------CCCCCCC----------XXX-----------------------------------------------------------------------------------------------------------
-----------------------XXX---------XX-----------------------------XXCC----XX---------------------------------------XXX-----CC--XXXX--------------------XXXX----------
------------------------------------------------XX------------------------------------------------------------------------XX----------------XXX----------------------
-----------------------------------------XX---------------------------------------------------------------------------------------------XXX-CC-----------------------
-------------------------------------------------------------------------------------XXXX------CCCC---------------------------------------------XXX------------------
----------------XXXX------XXXXX-----------------------------XXXXXX----XX-----XX-----------------------XXXXXX-----------------XX---XXXXX------------------------------
--------------------------------------------------------------------------------XXXXXX-------------------------------------------------------------------------------
--------------------------------------------XXXXX--------------------------------------------------------------------------------------------------------------------
------------------------------------------------------------------------------------------------------------------------------------------------------------------XX-
XXXXXXXXXXX--XXXX--XXXX---------XXXX--XXXX----------------------------------------------XXXXXXXXX-XXXX------XXXXXX----XXXX-----XXXX------------------------XXXXXXXXXX
