----------------------------------------------------------------------------------------------------------------------------------------------------------------------------------------------------------
----------------------------------------------------------------------------------------------------------------------------------------------------------------------------------------------------------
----------------------------------------------------------------------------------------------------------------------------------------------------------------------------------------------------------
----------------------------------------------------------------------------------------------------------------------------------------------------------------------------------------------------------
----------------------------------------------------------------------------------E-----------------------------------------------------------------------------------------------------------------------
----------------------B---------------------------------------------------------BBBBBBBB---BBBB--------------P-----------BBB----BBBB--------------------------------------------------------XX------------
-------------------------------------------------------------------------------------------------------------------------------------------------------------------------------------------XXX------------
-------------------------------------------------------------------------------E----------------------------------------------------------------------------------------------------------XXXX------------
----------------------------------------------------------------B------------------------------------------------------------------------------------------------------------------------XXXXX------------
----------------B---BPBBB----------------------S----------S------------------BPB--------------B-----BB----B--B--B-----B----------BB------X--X----------XX--X------------BBBB------------XXXXXX------------
---------------------------------------S------XX---------XX-----------------------------------------------------------------------------XX--XX--------XXX--XX--------------------------XXXXXXX------------
-----------------------------S--------XX------XX---------XX----------------------------------------------------------------------------XXX--XXX------XXXX--XXX------S---------------S-XXXXXXXX------------
---------------------E------XX--------XX-E----XX-----E-E-XX------------------------------------E-E--------E-----------------EE-E-E----XXXX--XXXX----XXXXX--XXXX----XX---------EE---XXXXXXXXXXX--------X---
XXXXXXXXXXXXXXXXXXXXXXXXXXXXXXXXXXXXXXXXXXXXXXXXXXXXXXXXXXXXXXXXXXXXX--XXXXXXXXXXXXXXX---XXXXXXXXXXXXXXXXXXXXXXXXXXXXXXXXXXXXXXXXXXXXXXXXXXXXXXXXXXXXXXXX--XXXXXXXXXXXXXXXXXXXXXXXXXXXXXXXXXXXXXXXXXXXXXXX
