--------------------------------------------------------------------------------------------------------------------------------------------------------------------------------
--------------------------------------------------------------------------------------------------------------------------------------------------------------------------------
------------------------------------------------------------------------------------------------------------------------------------------------P-------------------------------
--------------------------------------------------------------------------------------------------------------------------------------------------------------------------------
--------------------------------------------------------------------------------E-----------------------------------------------------------------------------------------------
--------------------PBB-----------------------------------------------------BBBBBB----B----------------------------------------BBBBB------------------------------XX------------
--------------------------------------------------------------------------------------------------------------------------------------------------BB-------------XXX------------
---------------------------------------------------------B---------------------------------------------------------------------------------------------X--------XXXX------------
---------------------------------------------------------X-------------------E--------------------------------------------------E-------------BB------XX-------XXXXX------------
--------------------------------BBBB-------------------BBXBB----------E----BBBBBBB-----E---------------E-----------------------BBBBB-----------------XXX------XXXXXX------------
-----------------E---B-----------------B-----E---B--------------------S----------------S---------------S-----E------------E-----------X----B--------XXXX-----XXXXXXX------------
------------B--------X-------B--E------X---------X-----------B-------XX---------------XX---------B----XX-----S-----B------S-----------X----X-------XXXXX----XXXXXXXX------------
------------X--------B-------X-------------------B-----------X-------XX---------------XX---------X----XX-E--XX-----X-----XX-----------X----B------XXXXXX---XXXXXXXXX--------X---
XXXXXXXXXXXXXXXXXXXXXXXXXXXXXXXXXXXXXXXXXXXXXXXXXXXXXXXXXXXXXXXXXX--XXXXXXXXXXXXXXXXXXXXXXXXXXXXXXXXXXXXXXXXXXXXXXXXXXXXXXXXXXXXXXXXXXXXXXXXXXXXX-XXXXXXXXXXXXXXXXXXXXXXXXXXXXXX
