-------------------------------------------------------------------------------------------------------------------------------------------------------------------------------------------------------------------------------------------------------------------------------------------------------------------------------------------------------------------------------------
-------------------------------------------------------------------------------------------------------------------------------------------------------------------------------------------------------------------------------------------------------------------------------------------------------------------------------------------------------------------------------------
-------------------------------------------------------------------------------------------------------------------------------------------------------------------------------------------------------------------------------------------------------------------------------------------------------------------------------------------------------------------------------------
-------------------------------------------------------------------------------------------------------------------------------------------------------------------------------------------------------------------------------------------------------------------------------------------------------------------------------------------------------------------------------------
------------------------------------------------------------------------------------------------------CC-----------------------------------------------------------------------------------------------------------------------------------------------------------------------------------------------------------------------------------------------------------------------------
---------------------------------------------------------------------------------------------------------------------------------------------------BBBBBBBB------------------------------------------------------------------------------------------------------------------------------------------------------------------------------------------------------------XX------------
-----------------------------------------------------------------------------------------------------------------------------------------------------------------------------------------------------------------------------------------------------------------------------------------------------------------------------------------------------------------------XX------------
------------------------------------------------------------------------------------------------------------------------------------------------------------------------------------------------------------------------------------------------E--------------------------------X-----------------------------------------------------------------------------------X-XX------------
-----------------------------E---------------------------C------------E--B--------C-----E--C------E------------------------------------------------------------------------------BBBBBBBB-------------------------------CC------------------E---S-------------------------------XX--CC------C----C-------------------CC---CC-----------------------------------------X-XX------------
-----------------------------S----------------------------------------S-----E-----------S---------S-----------------------------------E-----------X----B----X---------------------------------------------------------------------------E---S--XX------------------------------XXX----------------------------------------------------------------E----------------X-X-XX------------
----------------------------XX---------------------------------------XX-----S----------XX--------XX----------E------------------------S-----------X------E--X-------E-------------------------------------------------------------------S--XX--XX-----------------------------XXXX----------------------------------------------------------------S----------E-----X-X-XX------------
----------------------------XX---------------------------------------XX----XX----------XX--------XX----------S-----------------------XX-----------X---------X-----------E----------------------------------X---------------------------XX--XX--XX----------------------------XXXXX----------------------X---X------------------------------------XX----------S---X-X-X-XX------------
--------------E-EE-------E--XX----E-E---------------E---------EE-E---XX----XX----------XX--------XX-E-EE----XX-E-----E----EE-E-------XX-----E-EE--X---------X------------------------------------------EE--X---------------------EE-E--XX--XX--XX--------EE-E--E---------E--XXXXXX----------------------X-E-X-----------------------E------E-EE--XX---------XX---X-X-X-XX--------X---
XXXXXXXXXXXXXXXXXXXXXXXXXXXXXXXXXXXXXXX-X-XX-XX-XX-XXXXXXXXXXXXXXXXXXXXXXXXXXXXXXXXXXXXXXXXXXXXXXXXXXXXXXXXXXXXXXXXXXXXXXXXXXXXXXXXXXXXXXXXXXXXXXXXXXXXXXXXXXXXXXX-X-XX-X-XX-XXXXXXXXXXXXXXXXX-X-X-XXXXXXXXXXXXXXXXXXX------XXXXXXXXXX-XX--XX--XXXXXXXXXXXXXXXXXXXXXXXXXXXXXXXXXXXXXXXXXXXX---XX---XXXXXXXXXXXXXXXX-----X----XXXXXXXXXXXXXXXXXXXXXXXXXXXXXXXXXXX-X-X-X-XXXXXXXXXXXXXX
