------------------------------------------------------------------------------------------------------------------------------------------------------------------------------------------------------------------------------
------------------------------------------------------------------------------------------------------------------------------------------------------------------------------------------------------------------------------
------------------------------------------------------------------------------------------------------------------------------------------------------------------------------------------------------------------------------
------------------------------------------------------------------------------------------------------------------------------------------------------------------------------------------------------------------------------
------------------------------------------------------------------------------------------------------------------------------------------------------------------------------------------------------------------------------
------------------B--------------------------------------B-B-------------------------B-------------------------------------------------------BBBB---------------------------------------------------------------XX------------
--------------------------------------------------------------------------------------------------CCCC----------CCCC------------CCCC---------------------------------------------------------------------------XXX------------
--------------------------------------------------------------------------------------------------------------------------------------------------------------------------------------------------------------XXXX------------
-----------------------------------CC-------------------------------------------------------------------------E---------------E------------------------------------------------------------------------------XXXXX------------
---------------E--P---------------C--C-------------------B-B-----------------------BBBB-----------------------S---------------S------------BBPBBBBB---------------------------------------------------------XXXXXX---B--------
---------------S--------------------------------------------------------------------------------X------------XX--------------XX------------------------------E------------------------X--------------------XXXXXXX------------
--------------XX--------------------------------------------------------------------------------X------------XX--------------XX------------------------------S------------------------X-------------------XXXXXXXX------------
--------------XX--------------------------------------------------------------------------------X------------XX--------------XX-----------------------------XX------------------------X------------------XXXXXXXXX--------X---
XXXXXXXXXXXXXXXXXXXXXXXXX--XXXXXXXXXXXXXXXXXXXXXXXXXXXXXXXXXXXXXXXXXXXX----XXXXXXXXXXXXXXXXXXXXXXXXXXXXXXXXXXXXXXXXXXXXXXXXXXXXXXXXXXXXXXXXXXX--XXXXXXXXXXXXXXXXXXXXXXX---XXX--XXXXXXXX--XXXXXXXXXXXXXXXXXXXXXXXXXXXXXXXXXXXXX
