------------------------------------------------------------------------------------------------------------------------------------------------------------------------------------------------------
------------------------------------------------------------------------------------------------------------------------------------------------------------------------------------------------------
------------------------------------------------------------------------------------------------------------------------------------------------------------------------------------------------------
------------------------------------------------------------------------------------------------------------------------------------------------------------------------------------------------------
------------------------------------------------------------------------------------------------------------------------------------------------------------------------------------------------------
-------------------------------------------------------------------------------------BBB------------------------------------------------------------------------------------------------XX------------
--------------------------------------------------------------------------------------------------------------------------------------------------------E-------------------------------XX------------
--------------------------------------------------------------------------------------------------------------------------------------------------------S-------------------------------XX------------
-------------------------------------------------------------------------------------------------------------------------------------------------------XX----------------------------X--XX------------
----------------------------------------E------E-------------------------------E----XXXXX-----------------------------------------------------XBBB-----XX---------------------------XX--XX------------
----------------------------------------S------S----E--------------------------E----X--------------------------X------------------------------X----------------E-----------E----E--XXX--XX------------
---------------------------------------XX-----XX------------------------------------X---------------------B----X------------------------------X-----------B----S-----B------------XXXX----------------
----------E--E-EE-------EE-E-----E-----XX-----XX-----------EEE------EE-E------------X-------------EE-E----B----X---EE-E--E------E----------E-EX-----------B---XX-----B-----------XXXXX------------X---
XXXXXXXXXXXXXXXXXXXXXXXXXXXXXXXXXXXXXXXXXXXX--XXXXXXXXXXXXXXXXXXXXXXXXXXXXXXXXXXXXXXXXX----XXXXXXXXXXXXXXXXXX--XXXXXXXXXXXXXXXXXXXXXXXXXXXXXXXXXXXX---XXXXXXXXXXXXXXXXXXXXXXXXXXXXXXXXXXXXXXXXXXXXXXXX
