-----------------------------------------------------------------------------------------------------------------------------------------------------------------------------------------------------
-----------------------------------------------------------------------------------------------------------------------------------------------------------------------------------------------------
-----------------------------------------------------------------------------------------------------------------------------------------------------------------------------------------------------
---------------------------------------------------------------------------------------------------------------------------------------------------------------------------------------XX------------
---------------------------------------------------------------------------------------------------------------------------------------------------------------------------------------XX------------
---------------------BBBB---------------------BBBBB-----------BBBB--------BBBBB------BBBB-----------------------------PBBB-----------------------------------BBBBB---P-------------B---XX------------
---------------------------------------------------------------------------------------------------------------------------------------------------------------------------------------XX------------
----------------------------------------------------------------------------------------------------------------------------E----------------------------------------------------------XX------------
-----------------X----------------------E---------------------------E----------------------------E------------------E-------S----------------------------------------------------------XX------------
--------BPB-----EX---B-----X------------S----EPBBBB----------B------S---BBBB--BBB----------------S------------------S---E--XX-----------------------------B---E-----------E-------BB---XX------------
---------------XXX---------X-----------XX--------------------------XX---------------------------XX-----------E-----XX---S--XX----------------------X---------------E------S------------XX------------
--------------XXXX---------XX----------XX--------------------------XX---------------------------XX-----------S-----XX--XX--XX------------------E---X---------------------XX------------XX------------
-------------XXXXX----EE---XX---EE-----XX-----------E-E--E--EE-E---XX-------E-EE-------------E--XX--------E-XX--E--XX--XX--XX----------------------X-----EE--------------XXE-----------XX--------X---
XXXXXXXXXXXXXXXXXXXXXXXXXXXXXXXXXXXXXXXXXXXXXXXXXXXXXXXXXXXXXXXXXXXXXXXXXXXXXXXXXXXXX----XXXXXXXXXX---XXXXXXXXXXXXXXXXXXXXXXXXXXXXXX---XXXXXXXXXX--XXXXXXXXXXXXXXXXXXXXXXXXXXXXXXXXXXXXXXXXXXXXXXXXXX
