------------------------------------------------------------------------------------------------------------------------------------------------------
------------------------------------------------------------------------------------------------------------------------------------------------------
--------------------------------CC--------------------------------------------------------------------------------------------------------------------
------------------------------------E--E--------------------------------------------------------------------------------------------------------------
---------------------ECCC----------XXXXXXX-------------CCCC----------E------------------CC--CC--------------------------------------------------------
---------------------XXXXX-----------------------------XXXX----------E--E-------CC---------------------------E-----CC--------------------XX-----------
---------------------------------------------CC------------------------XXXXXX------------------------E---------------------XX------------XX-----------
---------------------------------------------------------------------------------------------------XXXXXXXX----------------------------XXXX-----------
------------------------------XXXXX----------------------------------------------XX----------------------------------------------------XXXX-----------
-------------------XXXXXXXX--------------------------------------XXX---------------------XX--------------------XXXX--XXXX------------XXXXXX-----------
--------------------------------------------------XXX-P------------------------------------------------------------------------------XXXXXX-----------
----------------------------C----------------------------------------------------------------XXXX------------------------------------XXXXXX-----------
-------------XXXX----------XXX------------------------------------------------------------------------------CCC------------------E---XXXXXX--------X--
XXXXXXXXXXX----------------------------------XXXX-----XXXXX-XXXXX-------------------------------------------XXX-------------XXXXXXXXXXXXXXXXXXXXXXXXXX
