--------------------------------------------------------------------------------------------------------------------------------------------------------------
--------------------------------------------------------------------------------------------------------------------------------------------------------------
B-----BBBBBBBBBBBBBBBBBBBBBBBBBBBBBBBBBBBBBBBBBBBBBBBBBBBBBBBBBBBBBBBBBBBBBBBBBBBBBBBBBBBPBBBBBBBBBBBBBBBBBBBBBBBBBBBBBBBBBBBBBBBBBBBBBBBB--------------------
B-----------------------------------------------------BB--BBBBBB--BBBB------BBBB------------------------------------------------------------------------------
B-----------------------------------------------------BB--BBBBBB--BBBB--E---BBBB------------------------------------------------------------XXX---------------
B----------------------------------------CCCC-------BB--------BB---B----BB----------CCCCCC-----------------------------------------------------------------XXX
B-----------------------------C---------------------BB--------BB---B----BB------------------------------------------------------------------------------------
B--------------------------------------B-BBBB-B-----BB--------BB---B----BB----------BBBBBB--------------------------------------------------------------------
B----------------------------B---------BCB--BCB-----BB----CCCCBB---BCPP-BB---E------BBBBBB--------------------E----------------------------------BBBBBPP------
B---------BBBBB--------XXXX------------BBB--BBB-----BBBB--BBBBBB---BBB--BB--BBBB------------------------E-----S-------------------------XXX-------------------
B--------------------XXXXXXXX--XX---------------------BB-------------------EE---------------------------S----XX-----E-----BB-----------EXXX-XXX---------------
B------------------XXXXXXXXXX--XXXX-------------------BB-----------------------------------------------XX----XX-----S-----BB---------EXXXXX-------------------
B-------------EE-XXXXXXXXXXXXE-XXXX-------EE---------E------E--E--------------------------------E-EE---XX----XX--E-XX-----BB---------XXXXXX---------E---------
XXXXXXXXXXXXXXXXXXXXXXXXXXXXXXXXXXXXXXXXXXXXXXXXXXXXXXXXXXXXXXXXXXXXXXXXXXXXXXXX---XXXXXXXXXXXXXXXXXXXXXXXXXXXXXXXXXXXXX--XX--XXXXXXXXXXXX-------XXXXXXXX--XXX
