-----------------------------------------------------------------------------------------------------------------------------------------------------------------------------------------------------------------------
-----------------------------------------------------------------------------------------------------------------------------------------------------------------------------------------------------------------------
-----------------------------------------------------------------------------------------------------------------------------------------------------------------------------------------------------------------------
--------------------C--------------------------------------------------------------------------------------------------------------------------------------------------------------------------------------------------
-----------------------------------------------------------------------------------------------------------------------------------------------------------------------------------------------------------------------
------------------BBB-------E---------------------------------BBBBB-----BBBBB------------------------------E--B---BBBBBBBBB------------BB---BB-------------BBB-----E---------------------------------E---XXX-----------
----------------------------S-----------------------------E------------------------E-----------------------S-------------------------------------------------------S------------------------------------XXXX-----------
---------------------------XX-----------------------E-----S------------------------S----------------------XX------------------------------------------------------XX-----------------------------------XXXXX-----------
---------------E--------E--XXX------------E---------S----XX-----------------------XX--------------E-------XX-------------------------BB---------------------------XX------E--------E-----------------EXXXXXX-----------
-----BBB-------S---B----S-----------------S---BB---XX----XXX----------------EB----XX------E-------S------BXXB------------------------------BBB-------E-XX--BBB----XXX-----S------E-S-----E-----------SXXXXXX-----------
--------------XX-------XX------E-E-------XX--------XX----------E------E-----S---E-XX------S------XX--E---------E---------------E---E--------------XX-S-XX----------------XX----E-SXX-----S----------XXXXXXXX-----------
--------------XX-------XX------S-S-------XX--------XX----------S------S----XX---S-XX-----XX------XX--S---------S---------------S---S-------------XXXXX-XXX---------------XX----SXXXX----XX---------XXXXXXXXX-----------
--------------XX----E--XX-----XXXX-------XX--------XX---------XX-----XX----XX--XX-XX-----XX------XX-XX--------XX--------------XX--XX------------XXXXXX-XXX--------E------XX---XXXXXX----XX--------XXXXXXXXXX-------XX--
XXXXXXXXXXXXXXXXXXXXXXXXXXXXXXXXXXXXXXXXXXXXXXXXXXXXXXXXXXXXXXXXXXXXXXXXXXXXXXXXXXXXXXXXXXXXXXXXXXXXXXXXXXXXXXXXXXXXXX------XXXXXXXXXXXX-X-XXXXXXXX-XXXXXXXXXXXXXXXXXXXXXXXXXXXXXXXXXXXXXXXXXXXXXXXXXXXXXXXXXXXXXXXXXXX
