----------------------------------------------------------------------------------------------------------------------------------------------------------------------------------------
----------------------------------------------------------------------------------------------------------------------------------------------------------------------------------------
----------------------------------------------------------------------------------------------------------------------------------------------------------------------------------------
----------------------------------------------------------------------------------------------------------------------------------------------------------------------------------------
----------------------------------------------------------------------------------------------------------------------------------------------------------------------------------------
-----------------------------BB---------------------------------------------------------------------------B--------------------------------------------------------------XXX------------
----------------------------------------------------------------------------------XBBB-----------------------------------------------------------------------------------XXX------------
-------------------------------------C-------------------------------CC----------XXX---------------------------------------------------------XBB--C----------------------XXX------------
--------------------------------------------------------------------------------XXXB--------------CCC------------------XBB-BB---------------XXX-----------------------XX-XXX------------
---------BB-----------------XXXX--BBB------------------CCC-------XXX------------XXXX------------E---------B-----------XXX------------------XXXX-BB-------------------XXX-XXX------------
-------------------------XXXXX----------------------------------XXXX----------XXXXXX-BBB--------S--------------------XXXX-----------------XXXXX---------------------XXXX-XXX------------
----------------------XXXXXX-----------------------------------XXXXX---------XXXXXXX-----------XX-------------------XXXXX----------------XXXXXX--BBB---------------XXXXX-XXX------------
-------------------XXXXXXX------------------------------------XXXXXX------------XXXX-----------XX------------------XXXXXX--BBBBB--------XXXXXXX-------------------XXXXXX-XXX-------XX---
XXXXXXXXXXXXX--XXXXXXXXX------XX--XXXXXXXXXXXXXXXX--XXXXXXXXXXXXXXX---XXXXXXXXXXXXXXXX---XXXXXXXXXXXXXXXXXXXXXXXXXXXXXXX-------XX-XXXXXXXXXXXX------XXXXXXXXX---XXXXXXX--XXXXXXXXXXXXXXX
