-----------------------------------------------------------------------------------------------------------------------------------------------------------------------------------------------------
-----------------------------------------------------------------------------------------------------------------------------------------------------------------------------------------------------
-------------------------------------------------------------------------------------------------------------------------------------------------------------------------------------------------E---
-----------------------------------------------------------------------------------------------------------------------------------------------------------------------------------------------------
------------------------------------------------------------------------------------------------------------------------------------------------E----------------------------------------------------
---------------------------------------------------------------------------B-------BBB------------------BBBBBBPBBB--------BBB------------------BBB--BBB--------------------------------XXX-----------
--------------------------------------------------------------------------------------------------------------------------------------------------------------------------------------XXXX-----------
--------------------------------------------------------------------------------------------------------------------------------------XX-------------------------C------XX-----------EXXXX-----------
------------B--P----------------E-----------------------------------------E-EE-------------------S------------------------BBB--------XXX--------------------------E-----XX----------XXXXXX-----------
---------B-E------EBBB----E----XX------------------E--B--------------X--------XX-XX-------------XX------BBBBBBBBBBB-----------------XXXX-------BBB--BPB--------BBBBB----XX---------XXXXXXX-----------
-----------E-------------XX-----------------------XX---------E------XXX-------XX-XX------------------------------------------------XXXXX--------------------E--E-------XXX-------EXXXXXXXX-----------
------------------------------------------------------------XX-----XXXX-------XX-XXX----------------------------------------------XXXXXX---------------------------E---XXX-------XXXXXXXXX-----------
------------------------------E-------------EE-E-----E------------XXXX--------X--XXX--E-E---E------------------------------------XXXXXXX-----E-----E-------------------XXX------XXXXXXXXXX-------XX--
XXXXXXXXXXXXXXXXXXXXXXXXXXXXXXXXXXXXXX---XXXXXXXXXXXXXXXXXXXXXXXXXXXXX--------X--XXXXXXXXXXXXXXXXXXXXXXXXXXXXXXXXXXXXXXXX----XXXXXXXXXX--XXXXXXXXXXXXXXXXXXXXXXXXXXXXXXXXX---XXXXXXXXXXXXXXXXXXXXXXXX
